station_name,taken_vmag_space,free_vmag_space,total_vmag_space,year,day&month,hour&min
001 Rue Jules Ferry - Gare Saint-Roch,5,7,12,2022,01-15,20:55
002 Comédie,11,13,24,2022,01-15,20:55
003 Esplanade,0,32,32,2022,01-15,20:55
004 Hôtel de Ville,6,10,16,2022,01-15,20:55
005 Corum,7,5,12,2022,01-15,20:55
006 Place Albert 1er - St Charles,11,20,31,2022,01-15,20:55
007 Foch,1,7,8,2022,01-15,20:55
008 Halles Castellane,3,9,12,2022,01-15,20:55
009 Observatoire,1,7,8,2022,01-15,20:55
010 Rondelet,4,12,16,2022,01-15,20:55
011 Plan Cabanes,7,5,12,2022,01-15,20:55
012 Boutonnet,6,6,12,2022,01-15,20:55
013 Emile Combes,6,2,8,2022,01-15,20:55
014 Beaux-Arts,6,2,8,2022,01-15,20:55
015 Les Aubes,7,1,8,2022,01-15,20:55
016 Antigone centre,7,9,16,2022,01-15,20:55
017 Médiathèque Emile Zola,7,9,16,2022,01-15,20:55
018 Nombre d'Or,8,8,16,2022,01-15,20:55
019 Louis Blanc,3,13,16,2022,01-15,20:55
020 Gambetta,2,6,8,2022,01-15,20:55
021 Port Marianne,14,2,16,2022,01-15,20:55
022 Clemenceau,0,12,12,2022,01-15,20:55
023 Les Arceaux,7,9,16,2022,01-15,20:55
024 Cité Mion,3,5,8,2022,01-15,20:55
025 Nouveau Saint-Roch,3,5,8,2022,01-15,20:55
026 Renouvier,3,5,8,2022,01-15,20:55
027 Odysseum,5,3,8,2022,01-15,20:55
028 Saint-Denis,4,4,8,2022,01-15,20:55
029 Richter,12,4,16,2022,01-15,20:55
030 Charles Flahault,3,5,8,2022,01-15,20:55
031 Voltaire,6,2,8,2022,01-15,20:55
032 Prés d'Arènes,8,0,8,2022,01-15,20:55
033 Garcia Lorca,7,1,8,2022,01-15,20:55
034 Vert Bois,0,16,16,2022,01-15,20:55
035 Malbosc,4,4,8,2022,01-15,20:55
036 Occitanie,1,31,32,2022,01-15,20:55
037 FacdesSciences,3,21,24,2022,01-15,20:55
038 Fac de Lettres,0,16,16,2022,01-15,20:55
039 Aiguelongue,8,0,8,2022,01-15,20:55
040 Jeu de Mail des Abbés,6,2,8,2022,01-15,20:55
041 Euromédecine,3,5,8,2022,01-15,20:55
042 Marie Caizergues,0,8,8,2022,01-15,20:55
043 Sabines,6,2,8,2022,01-15,20:55
044 Celleneuve,6,2,8,2022,01-15,20:55
045 Jardin de la Lironde,4,4,8,2022,01-15,20:55
046 Père Soulas,5,3,8,2022,01-15,20:55
047 Place Viala,4,4,8,2022,01-15,20:55
048 Hôtel du Département,2,6,8,2022,01-15,20:55
049 Tonnelles,1,7,8,2022,01-15,20:55
050 Parvis Jules Ferry - Gare Saint-Roch,3,5,8,2022,01-15,20:55
051 Pont de Lattes - Gare Saint-Roch,6,6,12,2022,01-15,20:55
053 Deux Ponts - Gare Saint-Roch,3,5,8,2022,01-15,20:55
054 Providence - Ovalie,0,8,8,2022,01-15,20:55
055 Pérols Etang de l'Or,22,46,68,2022,01-15,20:55
056 Albert 1er - Cathédrale,1,11,12,2022,01-15,20:55
057 Saint-Guilhem - Courreau,5,3,8,2022,01-15,20:55
059 Sud De France,1,7,8,2022,01-15,20:55
station_name,taken_vmag_space,free_vmag_space,total_vmag_space,year,day&month,hour&min
001 Rue Jules Ferry - Gare Saint-Roch,5,7,12,2022,01-15,21:00
002 Comédie,11,13,24,2022,01-15,21:00
003 Esplanade,0,32,32,2022,01-15,21:00
004 Hôtel de Ville,6,10,16,2022,01-15,21:00
005 Corum,7,5,12,2022,01-15,21:00
006 Place Albert 1er - St Charles,11,20,31,2022,01-15,21:00
007 Foch,1,7,8,2022,01-15,21:00
008 Halles Castellane,3,9,12,2022,01-15,21:00
009 Observatoire,1,7,8,2022,01-15,21:00
010 Rondelet,4,12,16,2022,01-15,21:00
011 Plan Cabanes,7,5,12,2022,01-15,21:00
012 Boutonnet,5,7,12,2022,01-15,21:00
013 Emile Combes,6,2,8,2022,01-15,21:00
014 Beaux-Arts,6,2,8,2022,01-15,21:00
015 Les Aubes,7,1,8,2022,01-15,21:00
016 Antigone centre,7,9,16,2022,01-15,21:00
017 Médiathèque Emile Zola,7,9,16,2022,01-15,21:00
018 Nombre d'Or,8,8,16,2022,01-15,21:00
019 Louis Blanc,3,13,16,2022,01-15,21:00
020 Gambetta,2,6,8,2022,01-15,21:00
021 Port Marianne,13,3,16,2022,01-15,21:00
022 Clemenceau,0,12,12,2022,01-15,21:00
023 Les Arceaux,7,9,16,2022,01-15,21:00
024 Cité Mion,3,5,8,2022,01-15,21:00
025 Nouveau Saint-Roch,3,5,8,2022,01-15,21:00
026 Renouvier,3,5,8,2022,01-15,21:00
027 Odysseum,5,3,8,2022,01-15,21:00
028 Saint-Denis,3,5,8,2022,01-15,21:00
029 Richter,12,4,16,2022,01-15,21:00
030 Charles Flahault,3,5,8,2022,01-15,21:00
031 Voltaire,6,2,8,2022,01-15,21:00
032 Prés d'Arènes,8,0,8,2022,01-15,21:00
033 Garcia Lorca,6,2,8,2022,01-15,21:00
034 Vert Bois,0,16,16,2022,01-15,21:00
035 Malbosc,4,4,8,2022,01-15,21:00
036 Occitanie,1,31,32,2022,01-15,21:00
037 FacdesSciences,3,21,24,2022,01-15,21:00
038 Fac de Lettres,0,16,16,2022,01-15,21:00
039 Aiguelongue,8,0,8,2022,01-15,21:00
040 Jeu de Mail des Abbés,6,2,8,2022,01-15,21:00
041 Euromédecine,3,5,8,2022,01-15,21:00
042 Marie Caizergues,0,8,8,2022,01-15,21:00
043 Sabines,6,2,8,2022,01-15,21:00
044 Celleneuve,6,2,8,2022,01-15,21:00
045 Jardin de la Lironde,4,4,8,2022,01-15,21:00
046 Père Soulas,5,3,8,2022,01-15,21:00
047 Place Viala,3,5,8,2022,01-15,21:00
048 Hôtel du Département,2,6,8,2022,01-15,21:00
049 Tonnelles,1,7,8,2022,01-15,21:00
050 Parvis Jules Ferry - Gare Saint-Roch,3,5,8,2022,01-15,21:00
051 Pont de Lattes - Gare Saint-Roch,6,6,12,2022,01-15,21:00
053 Deux Ponts - Gare Saint-Roch,3,5,8,2022,01-15,21:00
054 Providence - Ovalie,0,8,8,2022,01-15,21:00
055 Pérols Etang de l'Or,22,46,68,2022,01-15,21:00
056 Albert 1er - Cathédrale,1,11,12,2022,01-15,21:00
057 Saint-Guilhem - Courreau,5,3,8,2022,01-15,21:00
059 Sud De France,1,7,8,2022,01-15,21:00
station_name,taken_vmag_space,free_vmag_space,total_vmag_space,year,day&month,hour&min
001 Rue Jules Ferry - Gare Saint-Roch,5,7,12,2022,01-15,21:05
002 Comédie,11,13,24,2022,01-15,21:05
003 Esplanade,0,32,32,2022,01-15,21:05
004 Hôtel de Ville,6,10,16,2022,01-15,21:05
005 Corum,7,5,12,2022,01-15,21:05
006 Place Albert 1er - St Charles,11,20,31,2022,01-15,21:05
007 Foch,1,7,8,2022,01-15,21:05
008 Halles Castellane,3,9,12,2022,01-15,21:05
009 Observatoire,1,7,8,2022,01-15,21:05
010 Rondelet,4,12,16,2022,01-15,21:05
011 Plan Cabanes,7,5,12,2022,01-15,21:05
012 Boutonnet,5,7,12,2022,01-15,21:05
013 Emile Combes,6,2,8,2022,01-15,21:05
014 Beaux-Arts,6,2,8,2022,01-15,21:05
015 Les Aubes,7,1,8,2022,01-15,21:05
016 Antigone centre,7,9,16,2022,01-15,21:05
017 Médiathèque Emile Zola,7,9,16,2022,01-15,21:05
018 Nombre d'Or,8,8,16,2022,01-15,21:05
019 Louis Blanc,3,13,16,2022,01-15,21:05
020 Gambetta,2,6,8,2022,01-15,21:05
021 Port Marianne,13,3,16,2022,01-15,21:05
022 Clemenceau,0,12,12,2022,01-15,21:05
023 Les Arceaux,7,9,16,2022,01-15,21:05
024 Cité Mion,3,5,8,2022,01-15,21:05
025 Nouveau Saint-Roch,3,5,8,2022,01-15,21:05
026 Renouvier,3,5,8,2022,01-15,21:05
027 Odysseum,5,3,8,2022,01-15,21:05
028 Saint-Denis,4,4,8,2022,01-15,21:05
029 Richter,12,4,16,2022,01-15,21:05
030 Charles Flahault,3,5,8,2022,01-15,21:05
031 Voltaire,6,2,8,2022,01-15,21:05
032 Prés d'Arènes,8,0,8,2022,01-15,21:05
033 Garcia Lorca,7,1,8,2022,01-15,21:05
034 Vert Bois,0,16,16,2022,01-15,21:05
035 Malbosc,4,4,8,2022,01-15,21:05
036 Occitanie,1,31,32,2022,01-15,21:05
037 FacdesSciences,3,21,24,2022,01-15,21:05
038 Fac de Lettres,0,16,16,2022,01-15,21:05
039 Aiguelongue,8,0,8,2022,01-15,21:05
040 Jeu de Mail des Abbés,6,2,8,2022,01-15,21:05
041 Euromédecine,3,5,8,2022,01-15,21:05
042 Marie Caizergues,0,8,8,2022,01-15,21:05
043 Sabines,6,2,8,2022,01-15,21:05
044 Celleneuve,6,2,8,2022,01-15,21:05
045 Jardin de la Lironde,4,4,8,2022,01-15,21:05
046 Père Soulas,5,3,8,2022,01-15,21:05
047 Place Viala,4,4,8,2022,01-15,21:05
048 Hôtel du Département,2,6,8,2022,01-15,21:05
049 Tonnelles,1,7,8,2022,01-15,21:05
050 Parvis Jules Ferry - Gare Saint-Roch,3,5,8,2022,01-15,21:05
051 Pont de Lattes - Gare Saint-Roch,6,6,12,2022,01-15,21:05
053 Deux Ponts - Gare Saint-Roch,3,5,8,2022,01-15,21:05
054 Providence - Ovalie,0,8,8,2022,01-15,21:05
055 Pérols Etang de l'Or,22,46,68,2022,01-15,21:05
056 Albert 1er - Cathédrale,1,11,12,2022,01-15,21:05
057 Saint-Guilhem - Courreau,5,3,8,2022,01-15,21:05
059 Sud De France,1,7,8,2022,01-15,21:05
station_name,taken_vmag_space,free_vmag_space,total_vmag_space,year,day&month,hour&min
001 Rue Jules Ferry - Gare Saint-Roch,5,7,12,2022,01-15,21:10
002 Comédie,11,13,24,2022,01-15,21:10
003 Esplanade,1,31,32,2022,01-15,21:10
004 Hôtel de Ville,6,10,16,2022,01-15,21:10
005 Corum,7,5,12,2022,01-15,21:10
006 Place Albert 1er - St Charles,11,20,31,2022,01-15,21:10
007 Foch,1,7,8,2022,01-15,21:10
008 Halles Castellane,4,8,12,2022,01-15,21:10
009 Observatoire,1,7,8,2022,01-15,21:10
010 Rondelet,4,12,16,2022,01-15,21:10
011 Plan Cabanes,7,5,12,2022,01-15,21:10
012 Boutonnet,5,7,12,2022,01-15,21:10
013 Emile Combes,6,2,8,2022,01-15,21:10
014 Beaux-Arts,6,2,8,2022,01-15,21:10
015 Les Aubes,7,1,8,2022,01-15,21:10
016 Antigone centre,7,9,16,2022,01-15,21:10
017 Médiathèque Emile Zola,7,9,16,2022,01-15,21:10
018 Nombre d'Or,8,8,16,2022,01-15,21:10
019 Louis Blanc,3,13,16,2022,01-15,21:10
020 Gambetta,2,6,8,2022,01-15,21:10
021 Port Marianne,13,3,16,2022,01-15,21:10
022 Clemenceau,0,12,12,2022,01-15,21:10
023 Les Arceaux,7,9,16,2022,01-15,21:10
024 Cité Mion,3,5,8,2022,01-15,21:10
025 Nouveau Saint-Roch,3,5,8,2022,01-15,21:10
026 Renouvier,3,5,8,2022,01-15,21:10
027 Odysseum,5,3,8,2022,01-15,21:10
028 Saint-Denis,4,4,8,2022,01-15,21:10
029 Richter,12,4,16,2022,01-15,21:10
030 Charles Flahault,3,5,8,2022,01-15,21:10
031 Voltaire,6,2,8,2022,01-15,21:10
032 Prés d'Arènes,8,0,8,2022,01-15,21:10
033 Garcia Lorca,7,1,8,2022,01-15,21:10
034 Vert Bois,0,16,16,2022,01-15,21:10
035 Malbosc,4,4,8,2022,01-15,21:10
036 Occitanie,1,31,32,2022,01-15,21:10
037 FacdesSciences,3,21,24,2022,01-15,21:10
038 Fac de Lettres,0,16,16,2022,01-15,21:10
039 Aiguelongue,8,0,8,2022,01-15,21:10
040 Jeu de Mail des Abbés,6,2,8,2022,01-15,21:10
041 Euromédecine,3,5,8,2022,01-15,21:10
042 Marie Caizergues,0,8,8,2022,01-15,21:10
043 Sabines,6,2,8,2022,01-15,21:10
044 Celleneuve,6,2,8,2022,01-15,21:10
045 Jardin de la Lironde,4,4,8,2022,01-15,21:10
046 Père Soulas,5,3,8,2022,01-15,21:10
047 Place Viala,7,1,8,2022,01-15,21:10
048 Hôtel du Département,2,6,8,2022,01-15,21:10
049 Tonnelles,1,7,8,2022,01-15,21:10
050 Parvis Jules Ferry - Gare Saint-Roch,3,5,8,2022,01-15,21:10
051 Pont de Lattes - Gare Saint-Roch,7,5,12,2022,01-15,21:10
053 Deux Ponts - Gare Saint-Roch,3,5,8,2022,01-15,21:10
054 Providence - Ovalie,0,8,8,2022,01-15,21:10
055 Pérols Etang de l'Or,23,45,68,2022,01-15,21:10
056 Albert 1er - Cathédrale,1,11,12,2022,01-15,21:10
057 Saint-Guilhem - Courreau,5,3,8,2022,01-15,21:10
059 Sud De France,1,7,8,2022,01-15,21:10
station_name,taken_vmag_space,free_vmag_space,total_vmag_space,year,day&month,hour&min
001 Rue Jules Ferry - Gare Saint-Roch,5,7,12,2022,01-15,21:15
002 Comédie,11,13,24,2022,01-15,21:15
003 Esplanade,1,31,32,2022,01-15,21:15
004 Hôtel de Ville,6,10,16,2022,01-15,21:15
005 Corum,7,5,12,2022,01-15,21:15
006 Place Albert 1er - St Charles,11,20,31,2022,01-15,21:15
007 Foch,1,7,8,2022,01-15,21:15
008 Halles Castellane,4,8,12,2022,01-15,21:15
009 Observatoire,1,7,8,2022,01-15,21:15
010 Rondelet,4,12,16,2022,01-15,21:15
011 Plan Cabanes,7,5,12,2022,01-15,21:15
012 Boutonnet,5,7,12,2022,01-15,21:15
013 Emile Combes,6,2,8,2022,01-15,21:15
014 Beaux-Arts,6,2,8,2022,01-15,21:15
015 Les Aubes,7,1,8,2022,01-15,21:15
016 Antigone centre,8,8,16,2022,01-15,21:15
017 Médiathèque Emile Zola,7,9,16,2022,01-15,21:15
018 Nombre d'Or,8,8,16,2022,01-15,21:15
019 Louis Blanc,3,13,16,2022,01-15,21:15
020 Gambetta,1,7,8,2022,01-15,21:15
021 Port Marianne,13,3,16,2022,01-15,21:15
022 Clemenceau,0,12,12,2022,01-15,21:15
023 Les Arceaux,7,9,16,2022,01-15,21:15
024 Cité Mion,3,5,8,2022,01-15,21:15
025 Nouveau Saint-Roch,3,5,8,2022,01-15,21:15
026 Renouvier,3,5,8,2022,01-15,21:15
027 Odysseum,5,3,8,2022,01-15,21:15
028 Saint-Denis,4,4,8,2022,01-15,21:15
029 Richter,12,4,16,2022,01-15,21:15
030 Charles Flahault,3,5,8,2022,01-15,21:15
031 Voltaire,6,2,8,2022,01-15,21:15
032 Prés d'Arènes,8,0,8,2022,01-15,21:15
033 Garcia Lorca,7,1,8,2022,01-15,21:15
034 Vert Bois,0,16,16,2022,01-15,21:15
035 Malbosc,4,4,8,2022,01-15,21:15
036 Occitanie,1,31,32,2022,01-15,21:15
037 FacdesSciences,3,21,24,2022,01-15,21:15
038 Fac de Lettres,0,16,16,2022,01-15,21:15
039 Aiguelongue,8,0,8,2022,01-15,21:15
040 Jeu de Mail des Abbés,6,2,8,2022,01-15,21:15
041 Euromédecine,3,5,8,2022,01-15,21:15
042 Marie Caizergues,0,8,8,2022,01-15,21:15
043 Sabines,6,2,8,2022,01-15,21:15
044 Celleneuve,6,2,8,2022,01-15,21:15
045 Jardin de la Lironde,4,4,8,2022,01-15,21:15
046 Père Soulas,5,3,8,2022,01-15,21:15
047 Place Viala,7,1,8,2022,01-15,21:15
048 Hôtel du Département,2,6,8,2022,01-15,21:15
049 Tonnelles,1,7,8,2022,01-15,21:15
050 Parvis Jules Ferry - Gare Saint-Roch,3,5,8,2022,01-15,21:15
051 Pont de Lattes - Gare Saint-Roch,7,5,12,2022,01-15,21:15
053 Deux Ponts - Gare Saint-Roch,3,5,8,2022,01-15,21:15
054 Providence - Ovalie,0,8,8,2022,01-15,21:15
055 Pérols Etang de l'Or,23,45,68,2022,01-15,21:15
056 Albert 1er - Cathédrale,1,11,12,2022,01-15,21:15
057 Saint-Guilhem - Courreau,5,3,8,2022,01-15,21:15
059 Sud De France,1,7,8,2022,01-15,21:15
station_name,taken_vmag_space,free_vmag_space,total_vmag_space,year,day&month,hour&min
001 Rue Jules Ferry - Gare Saint-Roch,5,7,12,2022,01-15,21:20
002 Comédie,11,13,24,2022,01-15,21:20
003 Esplanade,1,31,32,2022,01-15,21:20
004 Hôtel de Ville,6,10,16,2022,01-15,21:20
005 Corum,7,5,12,2022,01-15,21:20
006 Place Albert 1er - St Charles,11,20,31,2022,01-15,21:20
007 Foch,1,7,8,2022,01-15,21:20
008 Halles Castellane,4,8,12,2022,01-15,21:20
009 Observatoire,1,7,8,2022,01-15,21:20
010 Rondelet,4,12,16,2022,01-15,21:20
011 Plan Cabanes,7,5,12,2022,01-15,21:20
012 Boutonnet,5,7,12,2022,01-15,21:20
013 Emile Combes,6,2,8,2022,01-15,21:20
014 Beaux-Arts,6,2,8,2022,01-15,21:20
015 Les Aubes,7,1,8,2022,01-15,21:20
016 Antigone centre,8,8,16,2022,01-15,21:20
017 Médiathèque Emile Zola,7,9,16,2022,01-15,21:20
018 Nombre d'Or,8,8,16,2022,01-15,21:20
019 Louis Blanc,3,13,16,2022,01-15,21:20
020 Gambetta,1,7,8,2022,01-15,21:20
021 Port Marianne,13,3,16,2022,01-15,21:20
022 Clemenceau,0,12,12,2022,01-15,21:20
023 Les Arceaux,7,9,16,2022,01-15,21:20
024 Cité Mion,3,5,8,2022,01-15,21:20
025 Nouveau Saint-Roch,3,5,8,2022,01-15,21:20
026 Renouvier,3,5,8,2022,01-15,21:20
027 Odysseum,5,3,8,2022,01-15,21:20
028 Saint-Denis,4,4,8,2022,01-15,21:20
029 Richter,12,4,16,2022,01-15,21:20
030 Charles Flahault,3,5,8,2022,01-15,21:20
031 Voltaire,6,2,8,2022,01-15,21:20
032 Prés d'Arènes,8,0,8,2022,01-15,21:20
033 Garcia Lorca,7,1,8,2022,01-15,21:20
034 Vert Bois,0,16,16,2022,01-15,21:20
035 Malbosc,4,4,8,2022,01-15,21:20
036 Occitanie,1,31,32,2022,01-15,21:20
037 FacdesSciences,4,20,24,2022,01-15,21:20
038 Fac de Lettres,0,16,16,2022,01-15,21:20
039 Aiguelongue,8,0,8,2022,01-15,21:20
040 Jeu de Mail des Abbés,6,2,8,2022,01-15,21:20
041 Euromédecine,3,5,8,2022,01-15,21:20
042 Marie Caizergues,0,8,8,2022,01-15,21:20
043 Sabines,6,2,8,2022,01-15,21:20
044 Celleneuve,6,2,8,2022,01-15,21:20
045 Jardin de la Lironde,4,4,8,2022,01-15,21:20
046 Père Soulas,5,3,8,2022,01-15,21:20
047 Place Viala,7,1,8,2022,01-15,21:20
048 Hôtel du Département,2,6,8,2022,01-15,21:20
049 Tonnelles,1,7,8,2022,01-15,21:20
050 Parvis Jules Ferry - Gare Saint-Roch,4,4,8,2022,01-15,21:20
051 Pont de Lattes - Gare Saint-Roch,7,5,12,2022,01-15,21:20
053 Deux Ponts - Gare Saint-Roch,3,5,8,2022,01-15,21:20
054 Providence - Ovalie,0,8,8,2022,01-15,21:20
055 Pérols Etang de l'Or,23,45,68,2022,01-15,21:20
056 Albert 1er - Cathédrale,1,11,12,2022,01-15,21:20
057 Saint-Guilhem - Courreau,5,3,8,2022,01-15,21:20
059 Sud De France,1,7,8,2022,01-15,21:20
station_name,taken_vmag_space,free_vmag_space,total_vmag_space,year,day&month,hour&min
001 Rue Jules Ferry - Gare Saint-Roch,5,7,12,2022,01-15,21:25
002 Comédie,11,13,24,2022,01-15,21:25
003 Esplanade,1,31,32,2022,01-15,21:25
004 Hôtel de Ville,6,10,16,2022,01-15,21:25
005 Corum,7,5,12,2022,01-15,21:25
006 Place Albert 1er - St Charles,11,20,31,2022,01-15,21:25
007 Foch,1,7,8,2022,01-15,21:25
008 Halles Castellane,4,8,12,2022,01-15,21:25
009 Observatoire,1,7,8,2022,01-15,21:25
010 Rondelet,4,12,16,2022,01-15,21:25
011 Plan Cabanes,6,6,12,2022,01-15,21:25
012 Boutonnet,4,8,12,2022,01-15,21:25
013 Emile Combes,6,2,8,2022,01-15,21:25
014 Beaux-Arts,6,2,8,2022,01-15,21:25
015 Les Aubes,7,1,8,2022,01-15,21:25
016 Antigone centre,8,8,16,2022,01-15,21:25
017 Médiathèque Emile Zola,7,9,16,2022,01-15,21:25
018 Nombre d'Or,8,8,16,2022,01-15,21:25
019 Louis Blanc,3,13,16,2022,01-15,21:25
020 Gambetta,1,7,8,2022,01-15,21:25
021 Port Marianne,13,3,16,2022,01-15,21:25
022 Clemenceau,0,12,12,2022,01-15,21:25
023 Les Arceaux,7,9,16,2022,01-15,21:25
024 Cité Mion,3,5,8,2022,01-15,21:25
025 Nouveau Saint-Roch,3,5,8,2022,01-15,21:25
026 Renouvier,3,5,8,2022,01-15,21:25
027 Odysseum,5,3,8,2022,01-15,21:25
028 Saint-Denis,4,4,8,2022,01-15,21:25
029 Richter,12,4,16,2022,01-15,21:25
030 Charles Flahault,3,5,8,2022,01-15,21:25
031 Voltaire,6,2,8,2022,01-15,21:25
032 Prés d'Arènes,8,0,8,2022,01-15,21:25
033 Garcia Lorca,7,1,8,2022,01-15,21:25
034 Vert Bois,0,16,16,2022,01-15,21:25
035 Malbosc,4,4,8,2022,01-15,21:25
036 Occitanie,1,31,32,2022,01-15,21:25
037 FacdesSciences,4,20,24,2022,01-15,21:25
038 Fac de Lettres,0,16,16,2022,01-15,21:25
039 Aiguelongue,8,0,8,2022,01-15,21:25
040 Jeu de Mail des Abbés,6,2,8,2022,01-15,21:25
041 Euromédecine,3,5,8,2022,01-15,21:25
042 Marie Caizergues,0,8,8,2022,01-15,21:25
043 Sabines,6,2,8,2022,01-15,21:25
044 Celleneuve,6,2,8,2022,01-15,21:25
045 Jardin de la Lironde,4,4,8,2022,01-15,21:25
046 Père Soulas,3,5,8,2022,01-15,21:25
047 Place Viala,7,1,8,2022,01-15,21:25
048 Hôtel du Département,2,6,8,2022,01-15,21:25
049 Tonnelles,1,7,8,2022,01-15,21:25
050 Parvis Jules Ferry - Gare Saint-Roch,4,4,8,2022,01-15,21:25
051 Pont de Lattes - Gare Saint-Roch,7,5,12,2022,01-15,21:25
053 Deux Ponts - Gare Saint-Roch,3,5,8,2022,01-15,21:25
054 Providence - Ovalie,0,8,8,2022,01-15,21:25
055 Pérols Etang de l'Or,23,45,68,2022,01-15,21:25
056 Albert 1er - Cathédrale,1,11,12,2022,01-15,21:25
057 Saint-Guilhem - Courreau,5,3,8,2022,01-15,21:25
059 Sud De France,1,7,8,2022,01-15,21:25
station_name,taken_vmag_space,free_vmag_space,total_vmag_space,year,day&month,hour&min
001 Rue Jules Ferry - Gare Saint-Roch,5,7,12,2022,01-15,21:30
002 Comédie,9,15,24,2022,01-15,21:30
003 Esplanade,1,31,32,2022,01-15,21:30
004 Hôtel de Ville,6,10,16,2022,01-15,21:30
005 Corum,7,5,12,2022,01-15,21:30
006 Place Albert 1er - St Charles,11,20,31,2022,01-15,21:30
007 Foch,1,7,8,2022,01-15,21:30
008 Halles Castellane,4,8,12,2022,01-15,21:30
009 Observatoire,2,6,8,2022,01-15,21:30
010 Rondelet,4,12,16,2022,01-15,21:30
011 Plan Cabanes,6,6,12,2022,01-15,21:30
012 Boutonnet,4,8,12,2022,01-15,21:30
013 Emile Combes,6,2,8,2022,01-15,21:30
014 Beaux-Arts,6,2,8,2022,01-15,21:30
015 Les Aubes,7,1,8,2022,01-15,21:30
016 Antigone centre,8,8,16,2022,01-15,21:30
017 Médiathèque Emile Zola,7,9,16,2022,01-15,21:30
018 Nombre d'Or,8,8,16,2022,01-15,21:30
019 Louis Blanc,3,13,16,2022,01-15,21:30
020 Gambetta,1,7,8,2022,01-15,21:30
021 Port Marianne,13,3,16,2022,01-15,21:30
022 Clemenceau,0,12,12,2022,01-15,21:30
023 Les Arceaux,7,9,16,2022,01-15,21:30
024 Cité Mion,3,5,8,2022,01-15,21:30
025 Nouveau Saint-Roch,4,4,8,2022,01-15,21:30
026 Renouvier,3,5,8,2022,01-15,21:30
027 Odysseum,5,3,8,2022,01-15,21:30
028 Saint-Denis,4,4,8,2022,01-15,21:30
029 Richter,12,4,16,2022,01-15,21:30
030 Charles Flahault,3,5,8,2022,01-15,21:30
031 Voltaire,6,2,8,2022,01-15,21:30
032 Prés d'Arènes,8,0,8,2022,01-15,21:30
033 Garcia Lorca,7,1,8,2022,01-15,21:30
034 Vert Bois,0,16,16,2022,01-15,21:30
035 Malbosc,3,5,8,2022,01-15,21:30
036 Occitanie,1,31,32,2022,01-15,21:30
037 FacdesSciences,4,20,24,2022,01-15,21:30
038 Fac de Lettres,0,16,16,2022,01-15,21:30
039 Aiguelongue,8,0,8,2022,01-15,21:30
040 Jeu de Mail des Abbés,3,5,8,2022,01-15,21:30
041 Euromédecine,3,5,8,2022,01-15,21:30
042 Marie Caizergues,0,8,8,2022,01-15,21:30
043 Sabines,6,2,8,2022,01-15,21:30
044 Celleneuve,6,2,8,2022,01-15,21:30
045 Jardin de la Lironde,4,4,8,2022,01-15,21:30
046 Père Soulas,2,6,8,2022,01-15,21:30
047 Place Viala,7,1,8,2022,01-15,21:30
048 Hôtel du Département,2,6,8,2022,01-15,21:30
049 Tonnelles,1,7,8,2022,01-15,21:30
050 Parvis Jules Ferry - Gare Saint-Roch,4,4,8,2022,01-15,21:30
051 Pont de Lattes - Gare Saint-Roch,7,5,12,2022,01-15,21:30
053 Deux Ponts - Gare Saint-Roch,3,5,8,2022,01-15,21:30
054 Providence - Ovalie,0,8,8,2022,01-15,21:30
055 Pérols Etang de l'Or,23,45,68,2022,01-15,21:30
056 Albert 1er - Cathédrale,1,11,12,2022,01-15,21:30
057 Saint-Guilhem - Courreau,5,3,8,2022,01-15,21:30
059 Sud De France,1,7,8,2022,01-15,21:30
station_name,taken_vmag_space,free_vmag_space,total_vmag_space,year,day&month,hour&min
001 Rue Jules Ferry - Gare Saint-Roch,4,8,12,2022,01-15,21:35
002 Comédie,9,15,24,2022,01-15,21:35
003 Esplanade,1,31,32,2022,01-15,21:35
004 Hôtel de Ville,6,10,16,2022,01-15,21:35
005 Corum,7,5,12,2022,01-15,21:35
006 Place Albert 1er - St Charles,11,20,31,2022,01-15,21:35
007 Foch,1,7,8,2022,01-15,21:35
008 Halles Castellane,7,5,12,2022,01-15,21:35
009 Observatoire,2,6,8,2022,01-15,21:35
010 Rondelet,4,12,16,2022,01-15,21:35
011 Plan Cabanes,6,6,12,2022,01-15,21:35
012 Boutonnet,4,8,12,2022,01-15,21:35
013 Emile Combes,6,2,8,2022,01-15,21:35
014 Beaux-Arts,6,2,8,2022,01-15,21:35
015 Les Aubes,7,1,8,2022,01-15,21:35
016 Antigone centre,8,8,16,2022,01-15,21:35
017 Médiathèque Emile Zola,7,9,16,2022,01-15,21:35
018 Nombre d'Or,8,8,16,2022,01-15,21:35
019 Louis Blanc,3,13,16,2022,01-15,21:35
020 Gambetta,3,5,8,2022,01-15,21:35
021 Port Marianne,13,3,16,2022,01-15,21:35
022 Clemenceau,0,12,12,2022,01-15,21:35
023 Les Arceaux,7,9,16,2022,01-15,21:35
024 Cité Mion,3,5,8,2022,01-15,21:35
025 Nouveau Saint-Roch,4,4,8,2022,01-15,21:35
026 Renouvier,3,5,8,2022,01-15,21:35
027 Odysseum,5,3,8,2022,01-15,21:35
028 Saint-Denis,4,4,8,2022,01-15,21:35
029 Richter,12,4,16,2022,01-15,21:35
030 Charles Flahault,3,5,8,2022,01-15,21:35
031 Voltaire,6,2,8,2022,01-15,21:35
032 Prés d'Arènes,8,0,8,2022,01-15,21:35
033 Garcia Lorca,7,1,8,2022,01-15,21:35
034 Vert Bois,0,16,16,2022,01-15,21:35
035 Malbosc,3,5,8,2022,01-15,21:35
036 Occitanie,1,31,32,2022,01-15,21:35
037 FacdesSciences,4,20,24,2022,01-15,21:35
038 Fac de Lettres,0,16,16,2022,01-15,21:35
039 Aiguelongue,8,0,8,2022,01-15,21:35
040 Jeu de Mail des Abbés,3,5,8,2022,01-15,21:35
041 Euromédecine,3,5,8,2022,01-15,21:35
042 Marie Caizergues,0,8,8,2022,01-15,21:35
043 Sabines,6,2,8,2022,01-15,21:35
044 Celleneuve,6,2,8,2022,01-15,21:35
045 Jardin de la Lironde,4,4,8,2022,01-15,21:35
046 Père Soulas,1,7,8,2022,01-15,21:35
047 Place Viala,7,1,8,2022,01-15,21:35
048 Hôtel du Département,2,6,8,2022,01-15,21:35
049 Tonnelles,1,7,8,2022,01-15,21:35
050 Parvis Jules Ferry - Gare Saint-Roch,4,4,8,2022,01-15,21:35
051 Pont de Lattes - Gare Saint-Roch,7,5,12,2022,01-15,21:35
053 Deux Ponts - Gare Saint-Roch,3,5,8,2022,01-15,21:35
054 Providence - Ovalie,0,8,8,2022,01-15,21:35
055 Pérols Etang de l'Or,23,45,68,2022,01-15,21:35
056 Albert 1er - Cathédrale,1,11,12,2022,01-15,21:35
057 Saint-Guilhem - Courreau,5,3,8,2022,01-15,21:35
059 Sud De France,1,7,8,2022,01-15,21:35
station_name,taken_vmag_space,free_vmag_space,total_vmag_space,year,day&month,hour&min
001 Rue Jules Ferry - Gare Saint-Roch,4,8,12,2022,01-15,21:40
002 Comédie,9,15,24,2022,01-15,21:40
003 Esplanade,1,31,32,2022,01-15,21:40
004 Hôtel de Ville,6,10,16,2022,01-15,21:40
005 Corum,8,4,12,2022,01-15,21:40
006 Place Albert 1er - St Charles,11,20,31,2022,01-15,21:40
007 Foch,1,7,8,2022,01-15,21:40
008 Halles Castellane,7,5,12,2022,01-15,21:40
009 Observatoire,2,6,8,2022,01-15,21:40
010 Rondelet,4,12,16,2022,01-15,21:40
011 Plan Cabanes,6,6,12,2022,01-15,21:40
012 Boutonnet,4,8,12,2022,01-15,21:40
013 Emile Combes,6,2,8,2022,01-15,21:40
014 Beaux-Arts,6,2,8,2022,01-15,21:40
015 Les Aubes,7,1,8,2022,01-15,21:40
016 Antigone centre,8,8,16,2022,01-15,21:40
017 Médiathèque Emile Zola,7,9,16,2022,01-15,21:40
018 Nombre d'Or,8,8,16,2022,01-15,21:40
019 Louis Blanc,2,14,16,2022,01-15,21:40
020 Gambetta,3,5,8,2022,01-15,21:40
021 Port Marianne,13,3,16,2022,01-15,21:40
022 Clemenceau,0,12,12,2022,01-15,21:40
023 Les Arceaux,7,9,16,2022,01-15,21:40
024 Cité Mion,3,5,8,2022,01-15,21:40
025 Nouveau Saint-Roch,4,4,8,2022,01-15,21:40
026 Renouvier,3,5,8,2022,01-15,21:40
027 Odysseum,5,3,8,2022,01-15,21:40
028 Saint-Denis,4,4,8,2022,01-15,21:40
029 Richter,12,4,16,2022,01-15,21:40
030 Charles Flahault,3,5,8,2022,01-15,21:40
031 Voltaire,6,2,8,2022,01-15,21:40
032 Prés d'Arènes,8,0,8,2022,01-15,21:40
033 Garcia Lorca,7,1,8,2022,01-15,21:40
034 Vert Bois,0,16,16,2022,01-15,21:40
035 Malbosc,3,5,8,2022,01-15,21:40
036 Occitanie,1,31,32,2022,01-15,21:40
037 FacdesSciences,4,20,24,2022,01-15,21:40
038 Fac de Lettres,0,16,16,2022,01-15,21:40
039 Aiguelongue,8,0,8,2022,01-15,21:40
040 Jeu de Mail des Abbés,3,5,8,2022,01-15,21:40
041 Euromédecine,3,5,8,2022,01-15,21:40
042 Marie Caizergues,0,8,8,2022,01-15,21:40
043 Sabines,6,2,8,2022,01-15,21:40
044 Celleneuve,6,2,8,2022,01-15,21:40
045 Jardin de la Lironde,4,4,8,2022,01-15,21:40
046 Père Soulas,2,6,8,2022,01-15,21:40
047 Place Viala,7,1,8,2022,01-15,21:40
048 Hôtel du Département,2,6,8,2022,01-15,21:40
049 Tonnelles,1,7,8,2022,01-15,21:40
050 Parvis Jules Ferry - Gare Saint-Roch,4,4,8,2022,01-15,21:40
051 Pont de Lattes - Gare Saint-Roch,7,5,12,2022,01-15,21:40
053 Deux Ponts - Gare Saint-Roch,3,5,8,2022,01-15,21:40
054 Providence - Ovalie,0,8,8,2022,01-15,21:40
055 Pérols Etang de l'Or,23,45,68,2022,01-15,21:40
056 Albert 1er - Cathédrale,1,11,12,2022,01-15,21:40
057 Saint-Guilhem - Courreau,5,3,8,2022,01-15,21:40
059 Sud De France,1,7,8,2022,01-15,21:40
station_name,taken_vmag_space,free_vmag_space,total_vmag_space,year,day&month,hour&min
001 Rue Jules Ferry - Gare Saint-Roch,4,8,12,2022,01-15,21:45
002 Comédie,9,15,24,2022,01-15,21:45
003 Esplanade,1,31,32,2022,01-15,21:45
004 Hôtel de Ville,6,10,16,2022,01-15,21:45
005 Corum,8,4,12,2022,01-15,21:45
006 Place Albert 1er - St Charles,11,20,31,2022,01-15,21:45
007 Foch,1,7,8,2022,01-15,21:45
008 Halles Castellane,7,5,12,2022,01-15,21:45
009 Observatoire,2,6,8,2022,01-15,21:45
010 Rondelet,4,12,16,2022,01-15,21:45
011 Plan Cabanes,6,6,12,2022,01-15,21:45
012 Boutonnet,4,8,12,2022,01-15,21:45
013 Emile Combes,6,2,8,2022,01-15,21:45
014 Beaux-Arts,6,2,8,2022,01-15,21:45
015 Les Aubes,7,1,8,2022,01-15,21:45
016 Antigone centre,8,8,16,2022,01-15,21:45
017 Médiathèque Emile Zola,7,9,16,2022,01-15,21:45
018 Nombre d'Or,8,8,16,2022,01-15,21:45
019 Louis Blanc,2,14,16,2022,01-15,21:45
020 Gambetta,3,5,8,2022,01-15,21:45
021 Port Marianne,13,3,16,2022,01-15,21:45
022 Clemenceau,0,12,12,2022,01-15,21:45
023 Les Arceaux,7,9,16,2022,01-15,21:45
024 Cité Mion,4,4,8,2022,01-15,21:45
025 Nouveau Saint-Roch,4,4,8,2022,01-15,21:45
026 Renouvier,3,5,8,2022,01-15,21:45
027 Odysseum,5,3,8,2022,01-15,21:45
028 Saint-Denis,4,4,8,2022,01-15,21:45
029 Richter,12,4,16,2022,01-15,21:45
030 Charles Flahault,3,5,8,2022,01-15,21:45
031 Voltaire,6,2,8,2022,01-15,21:45
032 Prés d'Arènes,8,0,8,2022,01-15,21:45
033 Garcia Lorca,7,1,8,2022,01-15,21:45
034 Vert Bois,0,16,16,2022,01-15,21:45
035 Malbosc,3,5,8,2022,01-15,21:45
036 Occitanie,1,31,32,2022,01-15,21:45
037 FacdesSciences,4,20,24,2022,01-15,21:45
038 Fac de Lettres,0,16,16,2022,01-15,21:45
039 Aiguelongue,8,0,8,2022,01-15,21:45
040 Jeu de Mail des Abbés,3,5,8,2022,01-15,21:45
041 Euromédecine,3,5,8,2022,01-15,21:45
042 Marie Caizergues,0,8,8,2022,01-15,21:45
043 Sabines,6,2,8,2022,01-15,21:45
044 Celleneuve,6,2,8,2022,01-15,21:45
045 Jardin de la Lironde,4,4,8,2022,01-15,21:45
046 Père Soulas,2,6,8,2022,01-15,21:45
047 Place Viala,7,1,8,2022,01-15,21:45
048 Hôtel du Département,2,6,8,2022,01-15,21:45
049 Tonnelles,1,7,8,2022,01-15,21:45
050 Parvis Jules Ferry - Gare Saint-Roch,4,4,8,2022,01-15,21:45
051 Pont de Lattes - Gare Saint-Roch,7,5,12,2022,01-15,21:45
053 Deux Ponts - Gare Saint-Roch,3,5,8,2022,01-15,21:45
054 Providence - Ovalie,0,8,8,2022,01-15,21:45
055 Pérols Etang de l'Or,23,45,68,2022,01-15,21:45
056 Albert 1er - Cathédrale,1,11,12,2022,01-15,21:45
057 Saint-Guilhem - Courreau,5,3,8,2022,01-15,21:45
059 Sud De France,1,7,8,2022,01-15,21:45
station_name,taken_vmag_space,free_vmag_space,total_vmag_space,year,day&month,hour&min
001 Rue Jules Ferry - Gare Saint-Roch,4,8,12,2022,01-15,21:50
002 Comédie,9,15,24,2022,01-15,21:50
003 Esplanade,1,31,32,2022,01-15,21:50
004 Hôtel de Ville,6,10,16,2022,01-15,21:50
005 Corum,8,4,12,2022,01-15,21:50
006 Place Albert 1er - St Charles,10,21,31,2022,01-15,21:50
007 Foch,1,7,8,2022,01-15,21:50
008 Halles Castellane,7,5,12,2022,01-15,21:50
009 Observatoire,2,6,8,2022,01-15,21:50
010 Rondelet,4,12,16,2022,01-15,21:50
011 Plan Cabanes,6,6,12,2022,01-15,21:50
012 Boutonnet,4,8,12,2022,01-15,21:50
013 Emile Combes,6,2,8,2022,01-15,21:50
014 Beaux-Arts,6,2,8,2022,01-15,21:50
015 Les Aubes,7,1,8,2022,01-15,21:50
016 Antigone centre,8,8,16,2022,01-15,21:50
017 Médiathèque Emile Zola,7,9,16,2022,01-15,21:50
018 Nombre d'Or,8,8,16,2022,01-15,21:50
019 Louis Blanc,2,14,16,2022,01-15,21:50
020 Gambetta,3,5,8,2022,01-15,21:50
021 Port Marianne,13,3,16,2022,01-15,21:50
022 Clemenceau,0,12,12,2022,01-15,21:50
023 Les Arceaux,7,9,16,2022,01-15,21:50
024 Cité Mion,4,4,8,2022,01-15,21:50
025 Nouveau Saint-Roch,4,4,8,2022,01-15,21:50
026 Renouvier,3,5,8,2022,01-15,21:50
027 Odysseum,5,3,8,2022,01-15,21:50
028 Saint-Denis,4,4,8,2022,01-15,21:50
029 Richter,12,4,16,2022,01-15,21:50
030 Charles Flahault,3,5,8,2022,01-15,21:50
031 Voltaire,6,2,8,2022,01-15,21:50
032 Prés d'Arènes,8,0,8,2022,01-15,21:50
033 Garcia Lorca,7,1,8,2022,01-15,21:50
034 Vert Bois,0,16,16,2022,01-15,21:50
035 Malbosc,3,5,8,2022,01-15,21:50
036 Occitanie,1,31,32,2022,01-15,21:50
037 FacdesSciences,4,20,24,2022,01-15,21:50
038 Fac de Lettres,0,16,16,2022,01-15,21:50
039 Aiguelongue,8,0,8,2022,01-15,21:50
040 Jeu de Mail des Abbés,3,5,8,2022,01-15,21:50
041 Euromédecine,3,5,8,2022,01-15,21:50
042 Marie Caizergues,0,8,8,2022,01-15,21:50
043 Sabines,6,2,8,2022,01-15,21:50
044 Celleneuve,6,2,8,2022,01-15,21:50
045 Jardin de la Lironde,4,4,8,2022,01-15,21:50
046 Père Soulas,2,6,8,2022,01-15,21:50
047 Place Viala,7,1,8,2022,01-15,21:50
048 Hôtel du Département,2,6,8,2022,01-15,21:50
049 Tonnelles,1,7,8,2022,01-15,21:50
050 Parvis Jules Ferry - Gare Saint-Roch,4,4,8,2022,01-15,21:50
051 Pont de Lattes - Gare Saint-Roch,7,5,12,2022,01-15,21:50
053 Deux Ponts - Gare Saint-Roch,3,5,8,2022,01-15,21:50
054 Providence - Ovalie,0,8,8,2022,01-15,21:50
055 Pérols Etang de l'Or,23,45,68,2022,01-15,21:50
056 Albert 1er - Cathédrale,1,11,12,2022,01-15,21:50
057 Saint-Guilhem - Courreau,5,3,8,2022,01-15,21:50
059 Sud De France,1,7,8,2022,01-15,21:50
station_name,taken_vmag_space,free_vmag_space,total_vmag_space,year,day&month,hour&min
001 Rue Jules Ferry - Gare Saint-Roch,4,8,12,2022,01-15,21:55
002 Comédie,12,12,24,2022,01-15,21:55
003 Esplanade,1,31,32,2022,01-15,21:55
004 Hôtel de Ville,6,10,16,2022,01-15,21:55
005 Corum,8,4,12,2022,01-15,21:55
006 Place Albert 1er - St Charles,10,21,31,2022,01-15,21:55
007 Foch,1,7,8,2022,01-15,21:55
008 Halles Castellane,7,5,12,2022,01-15,21:55
009 Observatoire,7,1,8,2022,01-15,21:55
010 Rondelet,4,12,16,2022,01-15,21:55
011 Plan Cabanes,6,6,12,2022,01-15,21:55
012 Boutonnet,4,8,12,2022,01-15,21:55
013 Emile Combes,6,2,8,2022,01-15,21:55
014 Beaux-Arts,6,2,8,2022,01-15,21:55
015 Les Aubes,7,1,8,2022,01-15,21:55
016 Antigone centre,7,9,16,2022,01-15,21:55
017 Médiathèque Emile Zola,7,9,16,2022,01-15,21:55
018 Nombre d'Or,8,8,16,2022,01-15,21:55
019 Louis Blanc,2,14,16,2022,01-15,21:55
020 Gambetta,3,5,8,2022,01-15,21:55
021 Port Marianne,13,3,16,2022,01-15,21:55
022 Clemenceau,0,12,12,2022,01-15,21:55
023 Les Arceaux,7,9,16,2022,01-15,21:55
024 Cité Mion,4,4,8,2022,01-15,21:55
025 Nouveau Saint-Roch,4,4,8,2022,01-15,21:55
026 Renouvier,3,5,8,2022,01-15,21:55
027 Odysseum,5,3,8,2022,01-15,21:55
028 Saint-Denis,4,4,8,2022,01-15,21:55
029 Richter,12,4,16,2022,01-15,21:55
030 Charles Flahault,3,5,8,2022,01-15,21:55
031 Voltaire,6,2,8,2022,01-15,21:55
032 Prés d'Arènes,8,0,8,2022,01-15,21:55
033 Garcia Lorca,7,1,8,2022,01-15,21:55
034 Vert Bois,0,16,16,2022,01-15,21:55
035 Malbosc,3,5,8,2022,01-15,21:55
036 Occitanie,2,30,32,2022,01-15,21:55
037 FacdesSciences,4,20,24,2022,01-15,21:55
038 Fac de Lettres,0,16,16,2022,01-15,21:55
039 Aiguelongue,8,0,8,2022,01-15,21:55
040 Jeu de Mail des Abbés,3,5,8,2022,01-15,21:55
041 Euromédecine,3,5,8,2022,01-15,21:55
042 Marie Caizergues,0,8,8,2022,01-15,21:55
043 Sabines,6,2,8,2022,01-15,21:55
044 Celleneuve,6,2,8,2022,01-15,21:55
045 Jardin de la Lironde,4,4,8,2022,01-15,21:55
046 Père Soulas,2,6,8,2022,01-15,21:55
047 Place Viala,7,1,8,2022,01-15,21:55
048 Hôtel du Département,2,6,8,2022,01-15,21:55
049 Tonnelles,1,7,8,2022,01-15,21:55
050 Parvis Jules Ferry - Gare Saint-Roch,4,4,8,2022,01-15,21:55
051 Pont de Lattes - Gare Saint-Roch,7,5,12,2022,01-15,21:55
053 Deux Ponts - Gare Saint-Roch,3,5,8,2022,01-15,21:55
054 Providence - Ovalie,0,8,8,2022,01-15,21:55
055 Pérols Etang de l'Or,23,45,68,2022,01-15,21:55
056 Albert 1er - Cathédrale,1,11,12,2022,01-15,21:55
057 Saint-Guilhem - Courreau,5,3,8,2022,01-15,21:55
059 Sud De France,1,7,8,2022,01-15,21:55
station_name,taken_vmag_space,free_vmag_space,total_vmag_space,year,day&month,hour&min
001 Rue Jules Ferry - Gare Saint-Roch,4,8,12,2022,01-15,22:00
002 Comédie,13,11,24,2022,01-15,22:00
003 Esplanade,1,31,32,2022,01-15,22:00
004 Hôtel de Ville,6,10,16,2022,01-15,22:00
005 Corum,8,4,12,2022,01-15,22:00
006 Place Albert 1er - St Charles,10,21,31,2022,01-15,22:00
007 Foch,1,7,8,2022,01-15,22:00
008 Halles Castellane,7,5,12,2022,01-15,22:00
009 Observatoire,7,1,8,2022,01-15,22:00
010 Rondelet,4,12,16,2022,01-15,22:00
011 Plan Cabanes,6,6,12,2022,01-15,22:00
012 Boutonnet,4,8,12,2022,01-15,22:00
013 Emile Combes,6,2,8,2022,01-15,22:00
014 Beaux-Arts,6,2,8,2022,01-15,22:00
015 Les Aubes,7,1,8,2022,01-15,22:00
016 Antigone centre,7,9,16,2022,01-15,22:00
017 Médiathèque Emile Zola,7,9,16,2022,01-15,22:00
018 Nombre d'Or,8,8,16,2022,01-15,22:00
019 Louis Blanc,2,14,16,2022,01-15,22:00
020 Gambetta,3,5,8,2022,01-15,22:00
021 Port Marianne,13,3,16,2022,01-15,22:00
022 Clemenceau,0,12,12,2022,01-15,22:00
023 Les Arceaux,6,10,16,2022,01-15,22:00
024 Cité Mion,4,4,8,2022,01-15,22:00
025 Nouveau Saint-Roch,4,4,8,2022,01-15,22:00
026 Renouvier,3,5,8,2022,01-15,22:00
027 Odysseum,5,3,8,2022,01-15,22:00
028 Saint-Denis,4,4,8,2022,01-15,22:00
029 Richter,13,3,16,2022,01-15,22:00
030 Charles Flahault,3,5,8,2022,01-15,22:00
031 Voltaire,6,2,8,2022,01-15,22:00
032 Prés d'Arènes,8,0,8,2022,01-15,22:00
033 Garcia Lorca,7,1,8,2022,01-15,22:00
034 Vert Bois,0,16,16,2022,01-15,22:00
035 Malbosc,3,5,8,2022,01-15,22:00
036 Occitanie,2,30,32,2022,01-15,22:00
037 FacdesSciences,4,20,24,2022,01-15,22:00
038 Fac de Lettres,0,16,16,2022,01-15,22:00
039 Aiguelongue,8,0,8,2022,01-15,22:00
040 Jeu de Mail des Abbés,3,5,8,2022,01-15,22:00
041 Euromédecine,3,5,8,2022,01-15,22:00
042 Marie Caizergues,0,8,8,2022,01-15,22:00
043 Sabines,6,2,8,2022,01-15,22:00
044 Celleneuve,6,2,8,2022,01-15,22:00
045 Jardin de la Lironde,4,4,8,2022,01-15,22:00
046 Père Soulas,2,6,8,2022,01-15,22:00
047 Place Viala,7,1,8,2022,01-15,22:00
048 Hôtel du Département,2,6,8,2022,01-15,22:00
049 Tonnelles,1,7,8,2022,01-15,22:00
050 Parvis Jules Ferry - Gare Saint-Roch,4,4,8,2022,01-15,22:00
051 Pont de Lattes - Gare Saint-Roch,7,5,12,2022,01-15,22:00
053 Deux Ponts - Gare Saint-Roch,3,5,8,2022,01-15,22:00
054 Providence - Ovalie,0,8,8,2022,01-15,22:00
055 Pérols Etang de l'Or,23,45,68,2022,01-15,22:00
056 Albert 1er - Cathédrale,1,11,12,2022,01-15,22:00
057 Saint-Guilhem - Courreau,5,3,8,2022,01-15,22:00
059 Sud De France,1,7,8,2022,01-15,22:00
station_name,taken_vmag_space,free_vmag_space,total_vmag_space,year,day&month,hour&min
001 Rue Jules Ferry - Gare Saint-Roch,4,8,12,2022,01-15,22:05
002 Comédie,13,11,24,2022,01-15,22:05
003 Esplanade,1,31,32,2022,01-15,22:05
004 Hôtel de Ville,6,10,16,2022,01-15,22:05
005 Corum,8,4,12,2022,01-15,22:05
006 Place Albert 1er - St Charles,10,21,31,2022,01-15,22:05
007 Foch,1,7,8,2022,01-15,22:05
008 Halles Castellane,7,5,12,2022,01-15,22:05
009 Observatoire,7,1,8,2022,01-15,22:05
010 Rondelet,4,12,16,2022,01-15,22:05
011 Plan Cabanes,6,6,12,2022,01-15,22:05
012 Boutonnet,4,8,12,2022,01-15,22:05
013 Emile Combes,6,2,8,2022,01-15,22:05
014 Beaux-Arts,6,2,8,2022,01-15,22:05
015 Les Aubes,7,1,8,2022,01-15,22:05
016 Antigone centre,7,9,16,2022,01-15,22:05
017 Médiathèque Emile Zola,7,9,16,2022,01-15,22:05
018 Nombre d'Or,8,8,16,2022,01-15,22:05
019 Louis Blanc,2,14,16,2022,01-15,22:05
020 Gambetta,3,5,8,2022,01-15,22:05
021 Port Marianne,13,3,16,2022,01-15,22:05
022 Clemenceau,0,12,12,2022,01-15,22:05
023 Les Arceaux,6,10,16,2022,01-15,22:05
024 Cité Mion,4,4,8,2022,01-15,22:05
025 Nouveau Saint-Roch,4,4,8,2022,01-15,22:05
026 Renouvier,3,5,8,2022,01-15,22:05
027 Odysseum,5,3,8,2022,01-15,22:05
028 Saint-Denis,4,4,8,2022,01-15,22:05
029 Richter,13,3,16,2022,01-15,22:05
030 Charles Flahault,3,5,8,2022,01-15,22:05
031 Voltaire,6,2,8,2022,01-15,22:05
032 Prés d'Arènes,8,0,8,2022,01-15,22:05
033 Garcia Lorca,7,1,8,2022,01-15,22:05
034 Vert Bois,0,16,16,2022,01-15,22:05
035 Malbosc,3,5,8,2022,01-15,22:05
036 Occitanie,3,29,32,2022,01-15,22:05
037 FacdesSciences,4,20,24,2022,01-15,22:05
038 Fac de Lettres,0,16,16,2022,01-15,22:05
039 Aiguelongue,8,0,8,2022,01-15,22:05
040 Jeu de Mail des Abbés,3,5,8,2022,01-15,22:05
041 Euromédecine,3,5,8,2022,01-15,22:05
042 Marie Caizergues,0,8,8,2022,01-15,22:05
043 Sabines,6,2,8,2022,01-15,22:05
044 Celleneuve,6,2,8,2022,01-15,22:05
045 Jardin de la Lironde,4,4,8,2022,01-15,22:05
046 Père Soulas,2,6,8,2022,01-15,22:05
047 Place Viala,7,1,8,2022,01-15,22:05
048 Hôtel du Département,2,6,8,2022,01-15,22:05
049 Tonnelles,1,7,8,2022,01-15,22:05
050 Parvis Jules Ferry - Gare Saint-Roch,4,4,8,2022,01-15,22:05
051 Pont de Lattes - Gare Saint-Roch,7,5,12,2022,01-15,22:05
053 Deux Ponts - Gare Saint-Roch,3,5,8,2022,01-15,22:05
054 Providence - Ovalie,0,8,8,2022,01-15,22:05
055 Pérols Etang de l'Or,23,45,68,2022,01-15,22:05
056 Albert 1er - Cathédrale,1,11,12,2022,01-15,22:05
057 Saint-Guilhem - Courreau,5,3,8,2022,01-15,22:05
059 Sud De France,1,7,8,2022,01-15,22:05
station_name,taken_vmag_space,free_vmag_space,total_vmag_space,year,day&month,hour&min
001 Rue Jules Ferry - Gare Saint-Roch,3,9,12,2022,01-15,22:10
002 Comédie,13,11,24,2022,01-15,22:10
003 Esplanade,1,31,32,2022,01-15,22:10
004 Hôtel de Ville,6,10,16,2022,01-15,22:10
005 Corum,8,4,12,2022,01-15,22:10
006 Place Albert 1er - St Charles,10,21,31,2022,01-15,22:10
007 Foch,1,7,8,2022,01-15,22:10
008 Halles Castellane,7,5,12,2022,01-15,22:10
009 Observatoire,7,1,8,2022,01-15,22:10
010 Rondelet,4,12,16,2022,01-15,22:10
011 Plan Cabanes,6,6,12,2022,01-15,22:10
012 Boutonnet,4,8,12,2022,01-15,22:10
013 Emile Combes,6,2,8,2022,01-15,22:10
014 Beaux-Arts,6,2,8,2022,01-15,22:10
015 Les Aubes,7,1,8,2022,01-15,22:10
016 Antigone centre,7,9,16,2022,01-15,22:10
017 Médiathèque Emile Zola,7,9,16,2022,01-15,22:10
018 Nombre d'Or,8,8,16,2022,01-15,22:10
019 Louis Blanc,2,14,16,2022,01-15,22:10
020 Gambetta,3,5,8,2022,01-15,22:10
021 Port Marianne,14,2,16,2022,01-15,22:10
022 Clemenceau,0,12,12,2022,01-15,22:10
023 Les Arceaux,6,10,16,2022,01-15,22:10
024 Cité Mion,4,4,8,2022,01-15,22:10
025 Nouveau Saint-Roch,4,4,8,2022,01-15,22:10
026 Renouvier,3,5,8,2022,01-15,22:10
027 Odysseum,5,3,8,2022,01-15,22:10
028 Saint-Denis,4,4,8,2022,01-15,22:10
029 Richter,13,3,16,2022,01-15,22:10
030 Charles Flahault,3,5,8,2022,01-15,22:10
031 Voltaire,6,2,8,2022,01-15,22:10
032 Prés d'Arènes,8,0,8,2022,01-15,22:10
033 Garcia Lorca,7,1,8,2022,01-15,22:10
034 Vert Bois,0,16,16,2022,01-15,22:10
035 Malbosc,3,5,8,2022,01-15,22:10
036 Occitanie,3,29,32,2022,01-15,22:10
037 FacdesSciences,4,20,24,2022,01-15,22:10
038 Fac de Lettres,0,16,16,2022,01-15,22:10
039 Aiguelongue,8,0,8,2022,01-15,22:10
040 Jeu de Mail des Abbés,3,5,8,2022,01-15,22:10
041 Euromédecine,3,5,8,2022,01-15,22:10
042 Marie Caizergues,0,8,8,2022,01-15,22:10
043 Sabines,6,2,8,2022,01-15,22:10
044 Celleneuve,6,2,8,2022,01-15,22:10
045 Jardin de la Lironde,4,4,8,2022,01-15,22:10
046 Père Soulas,2,6,8,2022,01-15,22:10
047 Place Viala,7,1,8,2022,01-15,22:10
048 Hôtel du Département,2,6,8,2022,01-15,22:10
049 Tonnelles,1,7,8,2022,01-15,22:10
050 Parvis Jules Ferry - Gare Saint-Roch,4,4,8,2022,01-15,22:10
051 Pont de Lattes - Gare Saint-Roch,7,5,12,2022,01-15,22:10
053 Deux Ponts - Gare Saint-Roch,3,5,8,2022,01-15,22:10
054 Providence - Ovalie,0,8,8,2022,01-15,22:10
055 Pérols Etang de l'Or,23,45,68,2022,01-15,22:10
056 Albert 1er - Cathédrale,1,11,12,2022,01-15,22:10
057 Saint-Guilhem - Courreau,5,3,8,2022,01-15,22:10
059 Sud De France,1,7,8,2022,01-15,22:10
station_name,taken_vmag_space,free_vmag_space,total_vmag_space,year,day&month,hour&min
001 Rue Jules Ferry - Gare Saint-Roch,2,10,12,2022,01-15,22:46
002 Comédie,13,11,24,2022,01-15,22:46
003 Esplanade,0,32,32,2022,01-15,22:46
004 Hôtel de Ville,7,9,16,2022,01-15,22:46
005 Corum,7,5,12,2022,01-15,22:46
006 Place Albert 1er - St Charles,8,23,31,2022,01-15,22:46
007 Foch,1,7,8,2022,01-15,22:46
008 Halles Castellane,2,10,12,2022,01-15,22:46
009 Observatoire,7,1,8,2022,01-15,22:46
010 Rondelet,4,12,16,2022,01-15,22:46
011 Plan Cabanes,5,7,12,2022,01-15,22:46
012 Boutonnet,4,8,12,2022,01-15,22:46
013 Emile Combes,6,2,8,2022,01-15,22:46
014 Beaux-Arts,6,2,8,2022,01-15,22:46
015 Les Aubes,7,1,8,2022,01-15,22:46
016 Antigone centre,6,10,16,2022,01-15,22:46
017 Médiathèque Emile Zola,7,9,16,2022,01-15,22:46
018 Nombre d'Or,8,8,16,2022,01-15,22:46
019 Louis Blanc,2,14,16,2022,01-15,22:46
020 Gambetta,3,5,8,2022,01-15,22:46
021 Port Marianne,14,2,16,2022,01-15,22:46
022 Clemenceau,0,12,12,2022,01-15,22:46
023 Les Arceaux,6,10,16,2022,01-15,22:46
024 Cité Mion,4,4,8,2022,01-15,22:46
025 Nouveau Saint-Roch,4,4,8,2022,01-15,22:46
026 Renouvier,3,5,8,2022,01-15,22:46
027 Odysseum,5,3,8,2022,01-15,22:46
028 Saint-Denis,3,5,8,2022,01-15,22:46
029 Richter,13,3,16,2022,01-15,22:46
030 Charles Flahault,3,5,8,2022,01-15,22:46
031 Voltaire,6,2,8,2022,01-15,22:46
032 Prés d'Arènes,8,0,8,2022,01-15,22:46
033 Garcia Lorca,7,1,8,2022,01-15,22:46
034 Vert Bois,0,16,16,2022,01-15,22:46
035 Malbosc,3,5,8,2022,01-15,22:46
036 Occitanie,2,30,32,2022,01-15,22:46
037 FacdesSciences,1,23,24,2022,01-15,22:46
038 Fac de Lettres,0,16,16,2022,01-15,22:46
039 Aiguelongue,8,0,8,2022,01-15,22:46
040 Jeu de Mail des Abbés,3,5,8,2022,01-15,22:46
041 Euromédecine,3,5,8,2022,01-15,22:46
042 Marie Caizergues,0,8,8,2022,01-15,22:46
043 Sabines,6,2,8,2022,01-15,22:46
044 Celleneuve,6,2,8,2022,01-15,22:46
045 Jardin de la Lironde,4,4,8,2022,01-15,22:46
046 Père Soulas,2,6,8,2022,01-15,22:46
047 Place Viala,7,1,8,2022,01-15,22:46
048 Hôtel du Département,2,6,8,2022,01-15,22:46
049 Tonnelles,0,8,8,2022,01-15,22:46
050 Parvis Jules Ferry - Gare Saint-Roch,4,4,8,2022,01-15,22:46
051 Pont de Lattes - Gare Saint-Roch,7,5,12,2022,01-15,22:46
053 Deux Ponts - Gare Saint-Roch,3,5,8,2022,01-15,22:46
054 Providence - Ovalie,0,8,8,2022,01-15,22:46
055 Pérols Etang de l'Or,23,45,68,2022,01-15,22:46
056 Albert 1er - Cathédrale,1,11,12,2022,01-15,22:46
057 Saint-Guilhem - Courreau,5,3,8,2022,01-15,22:46
059 Sud De France,1,7,8,2022,01-15,22:46
station_name,taken_vmag_space,free_vmag_space,total_vmag_space,year,day&month,hour&min
001 Rue Jules Ferry - Gare Saint-Roch,2,10,12,2022,01-15,22:51
002 Comédie,13,11,24,2022,01-15,22:51
003 Esplanade,0,32,32,2022,01-15,22:51
004 Hôtel de Ville,7,9,16,2022,01-15,22:51
005 Corum,8,4,12,2022,01-15,22:51
006 Place Albert 1er - St Charles,8,23,31,2022,01-15,22:51
007 Foch,1,7,8,2022,01-15,22:51
008 Halles Castellane,2,10,12,2022,01-15,22:51
009 Observatoire,7,1,8,2022,01-15,22:51
010 Rondelet,4,12,16,2022,01-15,22:51
011 Plan Cabanes,6,6,12,2022,01-15,22:51
012 Boutonnet,4,8,12,2022,01-15,22:51
013 Emile Combes,6,2,8,2022,01-15,22:51
014 Beaux-Arts,6,2,8,2022,01-15,22:51
015 Les Aubes,7,1,8,2022,01-15,22:51
016 Antigone centre,6,10,16,2022,01-15,22:51
017 Médiathèque Emile Zola,7,9,16,2022,01-15,22:51
018 Nombre d'Or,8,8,16,2022,01-15,22:51
019 Louis Blanc,2,14,16,2022,01-15,22:51
020 Gambetta,3,5,8,2022,01-15,22:51
021 Port Marianne,14,2,16,2022,01-15,22:51
022 Clemenceau,0,12,12,2022,01-15,22:51
023 Les Arceaux,8,8,16,2022,01-15,22:51
024 Cité Mion,4,4,8,2022,01-15,22:51
025 Nouveau Saint-Roch,4,4,8,2022,01-15,22:51
026 Renouvier,3,5,8,2022,01-15,22:51
027 Odysseum,6,2,8,2022,01-15,22:51
028 Saint-Denis,4,4,8,2022,01-15,22:51
029 Richter,13,3,16,2022,01-15,22:51
030 Charles Flahault,3,5,8,2022,01-15,22:51
031 Voltaire,6,2,8,2022,01-15,22:51
032 Prés d'Arènes,8,0,8,2022,01-15,22:51
033 Garcia Lorca,7,1,8,2022,01-15,22:51
034 Vert Bois,0,16,16,2022,01-15,22:51
035 Malbosc,3,5,8,2022,01-15,22:51
036 Occitanie,2,30,32,2022,01-15,22:51
037 FacdesSciences,1,23,24,2022,01-15,22:51
038 Fac de Lettres,0,16,16,2022,01-15,22:51
039 Aiguelongue,8,0,8,2022,01-15,22:51
040 Jeu de Mail des Abbés,3,5,8,2022,01-15,22:51
041 Euromédecine,3,5,8,2022,01-15,22:51
042 Marie Caizergues,0,8,8,2022,01-15,22:51
043 Sabines,6,2,8,2022,01-15,22:51
044 Celleneuve,6,2,8,2022,01-15,22:51
045 Jardin de la Lironde,4,4,8,2022,01-15,22:51
046 Père Soulas,3,5,8,2022,01-15,22:51
047 Place Viala,7,1,8,2022,01-15,22:51
048 Hôtel du Département,2,6,8,2022,01-15,22:51
049 Tonnelles,0,8,8,2022,01-15,22:51
050 Parvis Jules Ferry - Gare Saint-Roch,4,4,8,2022,01-15,22:51
051 Pont de Lattes - Gare Saint-Roch,7,5,12,2022,01-15,22:51
053 Deux Ponts - Gare Saint-Roch,3,5,8,2022,01-15,22:51
054 Providence - Ovalie,0,8,8,2022,01-15,22:51
055 Pérols Etang de l'Or,23,45,68,2022,01-15,22:51
056 Albert 1er - Cathédrale,1,11,12,2022,01-15,22:51
057 Saint-Guilhem - Courreau,5,3,8,2022,01-15,22:51
059 Sud De France,1,7,8,2022,01-15,22:51
station_name,taken_vmag_space,free_vmag_space,total_vmag_space,year,day&month,hour&min
001 Rue Jules Ferry - Gare Saint-Roch,2,10,12,2022,01-15,22:56
002 Comédie,13,11,24,2022,01-15,22:56
003 Esplanade,0,32,32,2022,01-15,22:56
004 Hôtel de Ville,7,9,16,2022,01-15,22:56
005 Corum,8,4,12,2022,01-15,22:56
006 Place Albert 1er - St Charles,8,23,31,2022,01-15,22:56
007 Foch,1,7,8,2022,01-15,22:56
008 Halles Castellane,2,10,12,2022,01-15,22:56
009 Observatoire,7,1,8,2022,01-15,22:56
010 Rondelet,4,12,16,2022,01-15,22:56
011 Plan Cabanes,6,6,12,2022,01-15,22:56
012 Boutonnet,4,8,12,2022,01-15,22:56
013 Emile Combes,6,2,8,2022,01-15,22:56
014 Beaux-Arts,6,2,8,2022,01-15,22:56
015 Les Aubes,7,1,8,2022,01-15,22:56
016 Antigone centre,6,10,16,2022,01-15,22:56
017 Médiathèque Emile Zola,7,9,16,2022,01-15,22:56
018 Nombre d'Or,8,8,16,2022,01-15,22:56
019 Louis Blanc,2,14,16,2022,01-15,22:56
020 Gambetta,3,5,8,2022,01-15,22:56
021 Port Marianne,14,2,16,2022,01-15,22:56
022 Clemenceau,0,12,12,2022,01-15,22:56
023 Les Arceaux,7,9,16,2022,01-15,22:56
024 Cité Mion,4,4,8,2022,01-15,22:56
025 Nouveau Saint-Roch,4,4,8,2022,01-15,22:56
026 Renouvier,3,5,8,2022,01-15,22:56
027 Odysseum,6,2,8,2022,01-15,22:56
028 Saint-Denis,4,4,8,2022,01-15,22:56
029 Richter,13,3,16,2022,01-15,22:56
030 Charles Flahault,3,5,8,2022,01-15,22:56
031 Voltaire,6,2,8,2022,01-15,22:56
032 Prés d'Arènes,8,0,8,2022,01-15,22:56
033 Garcia Lorca,7,1,8,2022,01-15,22:56
034 Vert Bois,0,16,16,2022,01-15,22:56
035 Malbosc,3,5,8,2022,01-15,22:56
036 Occitanie,2,30,32,2022,01-15,22:56
037 FacdesSciences,2,22,24,2022,01-15,22:56
038 Fac de Lettres,0,16,16,2022,01-15,22:56
039 Aiguelongue,8,0,8,2022,01-15,22:56
040 Jeu de Mail des Abbés,3,5,8,2022,01-15,22:56
041 Euromédecine,3,5,8,2022,01-15,22:56
042 Marie Caizergues,0,8,8,2022,01-15,22:56
043 Sabines,6,2,8,2022,01-15,22:56
044 Celleneuve,6,2,8,2022,01-15,22:56
045 Jardin de la Lironde,4,4,8,2022,01-15,22:56
046 Père Soulas,3,5,8,2022,01-15,22:56
047 Place Viala,7,1,8,2022,01-15,22:56
048 Hôtel du Département,2,6,8,2022,01-15,22:56
049 Tonnelles,0,8,8,2022,01-15,22:56
050 Parvis Jules Ferry - Gare Saint-Roch,4,4,8,2022,01-15,22:56
051 Pont de Lattes - Gare Saint-Roch,7,5,12,2022,01-15,22:56
053 Deux Ponts - Gare Saint-Roch,3,5,8,2022,01-15,22:56
054 Providence - Ovalie,0,8,8,2022,01-15,22:56
055 Pérols Etang de l'Or,23,45,68,2022,01-15,22:56
056 Albert 1er - Cathédrale,1,11,12,2022,01-15,22:56
057 Saint-Guilhem - Courreau,5,3,8,2022,01-15,22:56
059 Sud De France,1,7,8,2022,01-15,22:56
station_name,taken_vmag_space,free_vmag_space,total_vmag_space,year,day&month,hour&min
001 Rue Jules Ferry - Gare Saint-Roch,2,10,12,2022,01-15,23:01
002 Comédie,13,11,24,2022,01-15,23:01
003 Esplanade,0,32,32,2022,01-15,23:01
004 Hôtel de Ville,7,9,16,2022,01-15,23:01
005 Corum,8,4,12,2022,01-15,23:01
006 Place Albert 1er - St Charles,8,23,31,2022,01-15,23:01
007 Foch,1,7,8,2022,01-15,23:01
008 Halles Castellane,2,10,12,2022,01-15,23:01
009 Observatoire,7,1,8,2022,01-15,23:01
010 Rondelet,4,12,16,2022,01-15,23:01
011 Plan Cabanes,6,6,12,2022,01-15,23:01
012 Boutonnet,4,8,12,2022,01-15,23:01
013 Emile Combes,6,2,8,2022,01-15,23:01
014 Beaux-Arts,6,2,8,2022,01-15,23:01
015 Les Aubes,7,1,8,2022,01-15,23:01
016 Antigone centre,6,10,16,2022,01-15,23:01
017 Médiathèque Emile Zola,7,9,16,2022,01-15,23:01
018 Nombre d'Or,8,8,16,2022,01-15,23:01
019 Louis Blanc,2,14,16,2022,01-15,23:01
020 Gambetta,4,4,8,2022,01-15,23:01
021 Port Marianne,14,2,16,2022,01-15,23:01
022 Clemenceau,0,12,12,2022,01-15,23:01
023 Les Arceaux,7,9,16,2022,01-15,23:01
024 Cité Mion,4,4,8,2022,01-15,23:01
025 Nouveau Saint-Roch,4,4,8,2022,01-15,23:01
026 Renouvier,3,5,8,2022,01-15,23:01
027 Odysseum,6,2,8,2022,01-15,23:01
028 Saint-Denis,4,4,8,2022,01-15,23:01
029 Richter,13,3,16,2022,01-15,23:01
030 Charles Flahault,3,5,8,2022,01-15,23:01
031 Voltaire,6,2,8,2022,01-15,23:01
032 Prés d'Arènes,8,0,8,2022,01-15,23:01
033 Garcia Lorca,7,1,8,2022,01-15,23:01
034 Vert Bois,0,16,16,2022,01-15,23:01
035 Malbosc,3,5,8,2022,01-15,23:01
036 Occitanie,2,30,32,2022,01-15,23:01
037 FacdesSciences,2,22,24,2022,01-15,23:01
038 Fac de Lettres,0,16,16,2022,01-15,23:01
039 Aiguelongue,8,0,8,2022,01-15,23:01
040 Jeu de Mail des Abbés,3,5,8,2022,01-15,23:01
041 Euromédecine,3,5,8,2022,01-15,23:01
042 Marie Caizergues,0,8,8,2022,01-15,23:01
043 Sabines,6,2,8,2022,01-15,23:01
044 Celleneuve,6,2,8,2022,01-15,23:01
045 Jardin de la Lironde,4,4,8,2022,01-15,23:01
046 Père Soulas,1,7,8,2022,01-15,23:01
047 Place Viala,7,1,8,2022,01-15,23:01
048 Hôtel du Département,2,6,8,2022,01-15,23:01
049 Tonnelles,0,8,8,2022,01-15,23:01
050 Parvis Jules Ferry - Gare Saint-Roch,4,4,8,2022,01-15,23:01
051 Pont de Lattes - Gare Saint-Roch,7,5,12,2022,01-15,23:01
053 Deux Ponts - Gare Saint-Roch,3,5,8,2022,01-15,23:01
054 Providence - Ovalie,0,8,8,2022,01-15,23:01
055 Pérols Etang de l'Or,23,45,68,2022,01-15,23:01
056 Albert 1er - Cathédrale,1,11,12,2022,01-15,23:01
057 Saint-Guilhem - Courreau,5,3,8,2022,01-15,23:01
059 Sud De France,1,7,8,2022,01-15,23:01
station_name,taken_vmag_space,free_vmag_space,total_vmag_space,year,day&month,hour&min
001 Rue Jules Ferry - Gare Saint-Roch,2,10,12,2022,01-15,23:06
002 Comédie,13,11,24,2022,01-15,23:06
003 Esplanade,0,32,32,2022,01-15,23:06
004 Hôtel de Ville,7,9,16,2022,01-15,23:06
005 Corum,8,4,12,2022,01-15,23:06
006 Place Albert 1er - St Charles,9,22,31,2022,01-15,23:06
007 Foch,1,7,8,2022,01-15,23:06
008 Halles Castellane,0,12,12,2022,01-15,23:06
009 Observatoire,7,1,8,2022,01-15,23:06
010 Rondelet,4,12,16,2022,01-15,23:06
011 Plan Cabanes,6,6,12,2022,01-15,23:06
012 Boutonnet,4,8,12,2022,01-15,23:06
013 Emile Combes,6,2,8,2022,01-15,23:06
014 Beaux-Arts,6,2,8,2022,01-15,23:06
015 Les Aubes,7,1,8,2022,01-15,23:06
016 Antigone centre,6,10,16,2022,01-15,23:06
017 Médiathèque Emile Zola,7,9,16,2022,01-15,23:06
018 Nombre d'Or,8,8,16,2022,01-15,23:06
019 Louis Blanc,2,14,16,2022,01-15,23:06
020 Gambetta,4,4,8,2022,01-15,23:06
021 Port Marianne,13,3,16,2022,01-15,23:06
022 Clemenceau,0,12,12,2022,01-15,23:06
023 Les Arceaux,7,9,16,2022,01-15,23:06
024 Cité Mion,4,4,8,2022,01-15,23:06
025 Nouveau Saint-Roch,4,4,8,2022,01-15,23:06
026 Renouvier,3,5,8,2022,01-15,23:06
027 Odysseum,6,2,8,2022,01-15,23:06
028 Saint-Denis,4,4,8,2022,01-15,23:06
029 Richter,13,3,16,2022,01-15,23:06
030 Charles Flahault,3,5,8,2022,01-15,23:06
031 Voltaire,6,2,8,2022,01-15,23:06
032 Prés d'Arènes,8,0,8,2022,01-15,23:06
033 Garcia Lorca,7,1,8,2022,01-15,23:06
034 Vert Bois,0,16,16,2022,01-15,23:06
035 Malbosc,3,5,8,2022,01-15,23:06
036 Occitanie,2,30,32,2022,01-15,23:06
037 FacdesSciences,2,22,24,2022,01-15,23:06
038 Fac de Lettres,0,16,16,2022,01-15,23:06
039 Aiguelongue,8,0,8,2022,01-15,23:06
040 Jeu de Mail des Abbés,3,5,8,2022,01-15,23:06
041 Euromédecine,3,5,8,2022,01-15,23:06
042 Marie Caizergues,0,8,8,2022,01-15,23:06
043 Sabines,6,2,8,2022,01-15,23:06
044 Celleneuve,6,2,8,2022,01-15,23:06
045 Jardin de la Lironde,4,4,8,2022,01-15,23:06
046 Père Soulas,1,7,8,2022,01-15,23:06
047 Place Viala,7,1,8,2022,01-15,23:06
048 Hôtel du Département,2,6,8,2022,01-15,23:06
049 Tonnelles,0,8,8,2022,01-15,23:06
050 Parvis Jules Ferry - Gare Saint-Roch,4,4,8,2022,01-15,23:06
051 Pont de Lattes - Gare Saint-Roch,7,5,12,2022,01-15,23:06
053 Deux Ponts - Gare Saint-Roch,3,5,8,2022,01-15,23:06
054 Providence - Ovalie,0,8,8,2022,01-15,23:06
055 Pérols Etang de l'Or,23,45,68,2022,01-15,23:06
056 Albert 1er - Cathédrale,1,11,12,2022,01-15,23:06
057 Saint-Guilhem - Courreau,5,3,8,2022,01-15,23:06
059 Sud De France,1,7,8,2022,01-15,23:06
station_name,taken_vmag_space,free_vmag_space,total_vmag_space,year,day&month,hour&min
001 Rue Jules Ferry - Gare Saint-Roch,2,10,12,2022,01-15,23:11
002 Comédie,13,11,24,2022,01-15,23:11
003 Esplanade,0,32,32,2022,01-15,23:11
004 Hôtel de Ville,7,9,16,2022,01-15,23:11
005 Corum,8,4,12,2022,01-15,23:11
006 Place Albert 1er - St Charles,9,22,31,2022,01-15,23:11
007 Foch,1,7,8,2022,01-15,23:11
008 Halles Castellane,0,12,12,2022,01-15,23:11
009 Observatoire,7,1,8,2022,01-15,23:11
010 Rondelet,2,14,16,2022,01-15,23:11
011 Plan Cabanes,6,6,12,2022,01-15,23:11
012 Boutonnet,4,8,12,2022,01-15,23:11
013 Emile Combes,6,2,8,2022,01-15,23:11
014 Beaux-Arts,6,2,8,2022,01-15,23:11
015 Les Aubes,7,1,8,2022,01-15,23:11
016 Antigone centre,6,10,16,2022,01-15,23:11
017 Médiathèque Emile Zola,7,9,16,2022,01-15,23:11
018 Nombre d'Or,8,8,16,2022,01-15,23:11
019 Louis Blanc,2,14,16,2022,01-15,23:11
020 Gambetta,4,4,8,2022,01-15,23:11
021 Port Marianne,13,3,16,2022,01-15,23:11
022 Clemenceau,0,12,12,2022,01-15,23:11
023 Les Arceaux,7,9,16,2022,01-15,23:11
024 Cité Mion,4,4,8,2022,01-15,23:11
025 Nouveau Saint-Roch,4,4,8,2022,01-15,23:11
026 Renouvier,3,5,8,2022,01-15,23:11
027 Odysseum,6,2,8,2022,01-15,23:11
028 Saint-Denis,4,4,8,2022,01-15,23:11
029 Richter,13,3,16,2022,01-15,23:11
030 Charles Flahault,3,5,8,2022,01-15,23:11
031 Voltaire,6,2,8,2022,01-15,23:11
032 Prés d'Arènes,8,0,8,2022,01-15,23:11
033 Garcia Lorca,7,1,8,2022,01-15,23:11
034 Vert Bois,0,16,16,2022,01-15,23:11
035 Malbosc,3,5,8,2022,01-15,23:11
036 Occitanie,2,30,32,2022,01-15,23:11
037 FacdesSciences,2,22,24,2022,01-15,23:11
038 Fac de Lettres,0,16,16,2022,01-15,23:11
039 Aiguelongue,8,0,8,2022,01-15,23:11
040 Jeu de Mail des Abbés,3,5,8,2022,01-15,23:11
041 Euromédecine,3,5,8,2022,01-15,23:11
042 Marie Caizergues,0,8,8,2022,01-15,23:11
043 Sabines,6,2,8,2022,01-15,23:11
044 Celleneuve,6,2,8,2022,01-15,23:11
045 Jardin de la Lironde,4,4,8,2022,01-15,23:11
046 Père Soulas,1,7,8,2022,01-15,23:11
047 Place Viala,7,1,8,2022,01-15,23:11
048 Hôtel du Département,2,6,8,2022,01-15,23:11
049 Tonnelles,0,8,8,2022,01-15,23:11
050 Parvis Jules Ferry - Gare Saint-Roch,4,4,8,2022,01-15,23:11
051 Pont de Lattes - Gare Saint-Roch,7,5,12,2022,01-15,23:11
053 Deux Ponts - Gare Saint-Roch,3,5,8,2022,01-15,23:11
054 Providence - Ovalie,0,8,8,2022,01-15,23:11
055 Pérols Etang de l'Or,23,45,68,2022,01-15,23:11
056 Albert 1er - Cathédrale,1,11,12,2022,01-15,23:11
057 Saint-Guilhem - Courreau,5,3,8,2022,01-15,23:11
059 Sud De France,1,7,8,2022,01-15,23:11
station_name,taken_vmag_space,free_vmag_space,total_vmag_space,year,day&month,hour&min
001 Rue Jules Ferry - Gare Saint-Roch,2,10,12,2022,01-15,23:16
002 Comédie,13,11,24,2022,01-15,23:16
003 Esplanade,0,32,32,2022,01-15,23:16
004 Hôtel de Ville,7,9,16,2022,01-15,23:16
005 Corum,8,4,12,2022,01-15,23:16
006 Place Albert 1er - St Charles,9,22,31,2022,01-15,23:16
007 Foch,1,7,8,2022,01-15,23:16
008 Halles Castellane,0,12,12,2022,01-15,23:16
009 Observatoire,7,1,8,2022,01-15,23:16
010 Rondelet,2,14,16,2022,01-15,23:16
011 Plan Cabanes,6,6,12,2022,01-15,23:16
012 Boutonnet,4,8,12,2022,01-15,23:16
013 Emile Combes,6,2,8,2022,01-15,23:16
014 Beaux-Arts,6,2,8,2022,01-15,23:16
015 Les Aubes,7,1,8,2022,01-15,23:16
016 Antigone centre,6,10,16,2022,01-15,23:16
017 Médiathèque Emile Zola,7,9,16,2022,01-15,23:16
018 Nombre d'Or,8,8,16,2022,01-15,23:16
019 Louis Blanc,4,12,16,2022,01-15,23:16
020 Gambetta,4,4,8,2022,01-15,23:16
021 Port Marianne,13,3,16,2022,01-15,23:16
022 Clemenceau,0,12,12,2022,01-15,23:16
023 Les Arceaux,7,9,16,2022,01-15,23:16
024 Cité Mion,4,4,8,2022,01-15,23:16
025 Nouveau Saint-Roch,4,4,8,2022,01-15,23:16
026 Renouvier,3,5,8,2022,01-15,23:16
027 Odysseum,6,2,8,2022,01-15,23:16
028 Saint-Denis,4,4,8,2022,01-15,23:16
029 Richter,13,3,16,2022,01-15,23:16
030 Charles Flahault,3,5,8,2022,01-15,23:16
031 Voltaire,6,2,8,2022,01-15,23:16
032 Prés d'Arènes,8,0,8,2022,01-15,23:16
033 Garcia Lorca,7,1,8,2022,01-15,23:16
034 Vert Bois,0,16,16,2022,01-15,23:16
035 Malbosc,3,5,8,2022,01-15,23:16
036 Occitanie,2,30,32,2022,01-15,23:16
037 FacdesSciences,2,22,24,2022,01-15,23:16
038 Fac de Lettres,0,16,16,2022,01-15,23:16
039 Aiguelongue,8,0,8,2022,01-15,23:16
040 Jeu de Mail des Abbés,3,5,8,2022,01-15,23:16
041 Euromédecine,3,5,8,2022,01-15,23:16
042 Marie Caizergues,0,8,8,2022,01-15,23:16
043 Sabines,6,2,8,2022,01-15,23:16
044 Celleneuve,6,2,8,2022,01-15,23:16
045 Jardin de la Lironde,4,4,8,2022,01-15,23:16
046 Père Soulas,1,7,8,2022,01-15,23:16
047 Place Viala,7,1,8,2022,01-15,23:16
048 Hôtel du Département,2,6,8,2022,01-15,23:16
049 Tonnelles,0,8,8,2022,01-15,23:16
050 Parvis Jules Ferry - Gare Saint-Roch,4,4,8,2022,01-15,23:16
051 Pont de Lattes - Gare Saint-Roch,7,5,12,2022,01-15,23:16
053 Deux Ponts - Gare Saint-Roch,3,5,8,2022,01-15,23:16
054 Providence - Ovalie,0,8,8,2022,01-15,23:16
055 Pérols Etang de l'Or,23,45,68,2022,01-15,23:16
056 Albert 1er - Cathédrale,1,11,12,2022,01-15,23:16
057 Saint-Guilhem - Courreau,5,3,8,2022,01-15,23:16
059 Sud De France,1,7,8,2022,01-15,23:16
station_name,taken_vmag_space,free_vmag_space,total_vmag_space,year,day&month,hour&min
001 Rue Jules Ferry - Gare Saint-Roch,2,10,12,2022,01-15,23:21
002 Comédie,13,11,24,2022,01-15,23:21
003 Esplanade,0,32,32,2022,01-15,23:21
004 Hôtel de Ville,7,9,16,2022,01-15,23:21
005 Corum,8,4,12,2022,01-15,23:21
006 Place Albert 1er - St Charles,9,22,31,2022,01-15,23:21
007 Foch,1,7,8,2022,01-15,23:21
008 Halles Castellane,0,12,12,2022,01-15,23:21
009 Observatoire,8,0,8,2022,01-15,23:21
010 Rondelet,2,14,16,2022,01-15,23:21
011 Plan Cabanes,6,6,12,2022,01-15,23:21
012 Boutonnet,4,8,12,2022,01-15,23:21
013 Emile Combes,6,2,8,2022,01-15,23:21
014 Beaux-Arts,6,2,8,2022,01-15,23:21
015 Les Aubes,7,1,8,2022,01-15,23:21
016 Antigone centre,6,10,16,2022,01-15,23:21
017 Médiathèque Emile Zola,7,9,16,2022,01-15,23:21
018 Nombre d'Or,8,8,16,2022,01-15,23:21
019 Louis Blanc,4,12,16,2022,01-15,23:21
020 Gambetta,4,4,8,2022,01-15,23:21
021 Port Marianne,13,3,16,2022,01-15,23:21
022 Clemenceau,0,12,12,2022,01-15,23:21
023 Les Arceaux,7,9,16,2022,01-15,23:21
024 Cité Mion,4,4,8,2022,01-15,23:21
025 Nouveau Saint-Roch,4,4,8,2022,01-15,23:21
026 Renouvier,3,5,8,2022,01-15,23:21
027 Odysseum,6,2,8,2022,01-15,23:21
028 Saint-Denis,4,4,8,2022,01-15,23:21
029 Richter,13,3,16,2022,01-15,23:21
030 Charles Flahault,3,5,8,2022,01-15,23:21
031 Voltaire,6,2,8,2022,01-15,23:21
032 Prés d'Arènes,8,0,8,2022,01-15,23:21
033 Garcia Lorca,7,1,8,2022,01-15,23:21
034 Vert Bois,0,16,16,2022,01-15,23:21
035 Malbosc,3,5,8,2022,01-15,23:21
036 Occitanie,2,30,32,2022,01-15,23:21
037 FacdesSciences,2,22,24,2022,01-15,23:21
038 Fac de Lettres,0,16,16,2022,01-15,23:21
039 Aiguelongue,8,0,8,2022,01-15,23:21
040 Jeu de Mail des Abbés,3,5,8,2022,01-15,23:21
041 Euromédecine,3,5,8,2022,01-15,23:21
042 Marie Caizergues,0,8,8,2022,01-15,23:21
043 Sabines,6,2,8,2022,01-15,23:21
044 Celleneuve,6,2,8,2022,01-15,23:21
045 Jardin de la Lironde,4,4,8,2022,01-15,23:21
046 Père Soulas,1,7,8,2022,01-15,23:21
047 Place Viala,7,1,8,2022,01-15,23:21
048 Hôtel du Département,2,6,8,2022,01-15,23:21
049 Tonnelles,0,8,8,2022,01-15,23:21
050 Parvis Jules Ferry - Gare Saint-Roch,4,4,8,2022,01-15,23:21
051 Pont de Lattes - Gare Saint-Roch,7,5,12,2022,01-15,23:21
053 Deux Ponts - Gare Saint-Roch,3,5,8,2022,01-15,23:21
054 Providence - Ovalie,0,8,8,2022,01-15,23:21
055 Pérols Etang de l'Or,23,45,68,2022,01-15,23:21
056 Albert 1er - Cathédrale,1,11,12,2022,01-15,23:21
057 Saint-Guilhem - Courreau,5,3,8,2022,01-15,23:21
059 Sud De France,1,7,8,2022,01-15,23:21
station_name,taken_vmag_space,free_vmag_space,total_vmag_space,year,day&month,hour&min
001 Rue Jules Ferry - Gare Saint-Roch,2,10,12,2022,01-15,23:26
002 Comédie,13,11,24,2022,01-15,23:26
003 Esplanade,2,30,32,2022,01-15,23:26
004 Hôtel de Ville,7,9,16,2022,01-15,23:26
005 Corum,8,4,12,2022,01-15,23:26
006 Place Albert 1er - St Charles,9,22,31,2022,01-15,23:26
007 Foch,1,7,8,2022,01-15,23:26
008 Halles Castellane,0,12,12,2022,01-15,23:26
009 Observatoire,8,0,8,2022,01-15,23:26
010 Rondelet,2,14,16,2022,01-15,23:26
011 Plan Cabanes,6,6,12,2022,01-15,23:26
012 Boutonnet,4,8,12,2022,01-15,23:26
013 Emile Combes,6,2,8,2022,01-15,23:26
014 Beaux-Arts,6,2,8,2022,01-15,23:26
015 Les Aubes,6,2,8,2022,01-15,23:26
016 Antigone centre,6,10,16,2022,01-15,23:26
017 Médiathèque Emile Zola,7,9,16,2022,01-15,23:26
018 Nombre d'Or,8,8,16,2022,01-15,23:26
019 Louis Blanc,4,12,16,2022,01-15,23:26
020 Gambetta,4,4,8,2022,01-15,23:26
021 Port Marianne,13,3,16,2022,01-15,23:26
022 Clemenceau,0,12,12,2022,01-15,23:26
023 Les Arceaux,7,9,16,2022,01-15,23:26
024 Cité Mion,4,4,8,2022,01-15,23:26
025 Nouveau Saint-Roch,4,4,8,2022,01-15,23:26
026 Renouvier,3,5,8,2022,01-15,23:26
027 Odysseum,6,2,8,2022,01-15,23:26
028 Saint-Denis,4,4,8,2022,01-15,23:26
029 Richter,13,3,16,2022,01-15,23:26
030 Charles Flahault,3,5,8,2022,01-15,23:26
031 Voltaire,6,2,8,2022,01-15,23:26
032 Prés d'Arènes,8,0,8,2022,01-15,23:26
033 Garcia Lorca,7,1,8,2022,01-15,23:26
034 Vert Bois,0,16,16,2022,01-15,23:26
035 Malbosc,3,5,8,2022,01-15,23:26
036 Occitanie,2,30,32,2022,01-15,23:26
037 FacdesSciences,2,22,24,2022,01-15,23:26
038 Fac de Lettres,0,16,16,2022,01-15,23:26
039 Aiguelongue,8,0,8,2022,01-15,23:26
040 Jeu de Mail des Abbés,3,5,8,2022,01-15,23:26
041 Euromédecine,3,5,8,2022,01-15,23:26
042 Marie Caizergues,0,8,8,2022,01-15,23:26
043 Sabines,6,2,8,2022,01-15,23:26
044 Celleneuve,6,2,8,2022,01-15,23:26
045 Jardin de la Lironde,4,4,8,2022,01-15,23:26
046 Père Soulas,1,7,8,2022,01-15,23:26
047 Place Viala,4,4,8,2022,01-15,23:26
048 Hôtel du Département,2,6,8,2022,01-15,23:26
049 Tonnelles,0,8,8,2022,01-15,23:26
050 Parvis Jules Ferry - Gare Saint-Roch,4,4,8,2022,01-15,23:26
051 Pont de Lattes - Gare Saint-Roch,6,6,12,2022,01-15,23:26
053 Deux Ponts - Gare Saint-Roch,3,5,8,2022,01-15,23:26
054 Providence - Ovalie,0,8,8,2022,01-15,23:26
055 Pérols Etang de l'Or,23,45,68,2022,01-15,23:26
056 Albert 1er - Cathédrale,1,11,12,2022,01-15,23:26
057 Saint-Guilhem - Courreau,5,3,8,2022,01-15,23:26
059 Sud De France,1,7,8,2022,01-15,23:26
station_name,taken_vmag_space,free_vmag_space,total_vmag_space,year,day&month,hour&min
001 Rue Jules Ferry - Gare Saint-Roch,2,10,12,2022,01-15,23:31
002 Comédie,13,11,24,2022,01-15,23:31
003 Esplanade,2,30,32,2022,01-15,23:31
004 Hôtel de Ville,7,9,16,2022,01-15,23:31
005 Corum,9,3,12,2022,01-15,23:31
006 Place Albert 1er - St Charles,9,22,31,2022,01-15,23:31
007 Foch,1,7,8,2022,01-15,23:31
008 Halles Castellane,0,12,12,2022,01-15,23:31
009 Observatoire,8,0,8,2022,01-15,23:31
010 Rondelet,2,14,16,2022,01-15,23:31
011 Plan Cabanes,6,6,12,2022,01-15,23:31
012 Boutonnet,4,8,12,2022,01-15,23:31
013 Emile Combes,6,2,8,2022,01-15,23:31
014 Beaux-Arts,6,2,8,2022,01-15,23:31
015 Les Aubes,6,2,8,2022,01-15,23:31
016 Antigone centre,6,10,16,2022,01-15,23:31
017 Médiathèque Emile Zola,7,9,16,2022,01-15,23:31
018 Nombre d'Or,8,8,16,2022,01-15,23:31
019 Louis Blanc,4,12,16,2022,01-15,23:31
020 Gambetta,4,4,8,2022,01-15,23:31
021 Port Marianne,13,3,16,2022,01-15,23:31
022 Clemenceau,0,12,12,2022,01-15,23:31
023 Les Arceaux,7,9,16,2022,01-15,23:31
024 Cité Mion,4,4,8,2022,01-15,23:31
025 Nouveau Saint-Roch,4,4,8,2022,01-15,23:31
026 Renouvier,3,5,8,2022,01-15,23:31
027 Odysseum,6,2,8,2022,01-15,23:31
028 Saint-Denis,4,4,8,2022,01-15,23:31
029 Richter,13,3,16,2022,01-15,23:31
030 Charles Flahault,3,5,8,2022,01-15,23:31
031 Voltaire,6,2,8,2022,01-15,23:31
032 Prés d'Arènes,8,0,8,2022,01-15,23:31
033 Garcia Lorca,6,2,8,2022,01-15,23:31
034 Vert Bois,0,16,16,2022,01-15,23:31
035 Malbosc,3,5,8,2022,01-15,23:31
036 Occitanie,2,30,32,2022,01-15,23:31
037 FacdesSciences,2,22,24,2022,01-15,23:31
038 Fac de Lettres,0,16,16,2022,01-15,23:31
039 Aiguelongue,8,0,8,2022,01-15,23:31
040 Jeu de Mail des Abbés,3,5,8,2022,01-15,23:31
041 Euromédecine,3,5,8,2022,01-15,23:31
042 Marie Caizergues,0,8,8,2022,01-15,23:31
043 Sabines,6,2,8,2022,01-15,23:31
044 Celleneuve,6,2,8,2022,01-15,23:31
045 Jardin de la Lironde,4,4,8,2022,01-15,23:31
046 Père Soulas,1,7,8,2022,01-15,23:31
047 Place Viala,4,4,8,2022,01-15,23:31
048 Hôtel du Département,2,6,8,2022,01-15,23:31
049 Tonnelles,0,8,8,2022,01-15,23:31
050 Parvis Jules Ferry - Gare Saint-Roch,4,4,8,2022,01-15,23:31
051 Pont de Lattes - Gare Saint-Roch,6,6,12,2022,01-15,23:31
053 Deux Ponts - Gare Saint-Roch,3,5,8,2022,01-15,23:31
054 Providence - Ovalie,0,8,8,2022,01-15,23:31
055 Pérols Etang de l'Or,23,45,68,2022,01-15,23:31
056 Albert 1er - Cathédrale,1,11,12,2022,01-15,23:31
057 Saint-Guilhem - Courreau,5,3,8,2022,01-15,23:31
059 Sud De France,1,7,8,2022,01-15,23:31
station_name,taken_vmag_space,free_vmag_space,total_vmag_space,year,day&month,hour&min
001 Rue Jules Ferry - Gare Saint-Roch,2,10,12,2022,01-15,23:36
002 Comédie,13,11,24,2022,01-15,23:36
003 Esplanade,2,30,32,2022,01-15,23:36
004 Hôtel de Ville,7,9,16,2022,01-15,23:36
005 Corum,9,3,12,2022,01-15,23:36
006 Place Albert 1er - St Charles,9,22,31,2022,01-15,23:36
007 Foch,1,7,8,2022,01-15,23:36
008 Halles Castellane,0,12,12,2022,01-15,23:36
009 Observatoire,8,0,8,2022,01-15,23:36
010 Rondelet,2,14,16,2022,01-15,23:36
011 Plan Cabanes,6,6,12,2022,01-15,23:36
012 Boutonnet,4,8,12,2022,01-15,23:36
013 Emile Combes,6,2,8,2022,01-15,23:36
014 Beaux-Arts,6,2,8,2022,01-15,23:36
015 Les Aubes,6,2,8,2022,01-15,23:36
016 Antigone centre,6,10,16,2022,01-15,23:36
017 Médiathèque Emile Zola,7,9,16,2022,01-15,23:36
018 Nombre d'Or,8,8,16,2022,01-15,23:36
019 Louis Blanc,4,12,16,2022,01-15,23:36
020 Gambetta,4,4,8,2022,01-15,23:36
021 Port Marianne,13,3,16,2022,01-15,23:36
022 Clemenceau,0,12,12,2022,01-15,23:36
023 Les Arceaux,7,9,16,2022,01-15,23:36
024 Cité Mion,5,3,8,2022,01-15,23:36
025 Nouveau Saint-Roch,4,4,8,2022,01-15,23:36
026 Renouvier,3,5,8,2022,01-15,23:36
027 Odysseum,6,2,8,2022,01-15,23:36
028 Saint-Denis,4,4,8,2022,01-15,23:36
029 Richter,13,3,16,2022,01-15,23:36
030 Charles Flahault,3,5,8,2022,01-15,23:36
031 Voltaire,6,2,8,2022,01-15,23:36
032 Prés d'Arènes,8,0,8,2022,01-15,23:36
033 Garcia Lorca,6,2,8,2022,01-15,23:36
034 Vert Bois,0,16,16,2022,01-15,23:36
035 Malbosc,3,5,8,2022,01-15,23:36
036 Occitanie,2,30,32,2022,01-15,23:36
037 FacdesSciences,2,22,24,2022,01-15,23:36
038 Fac de Lettres,0,16,16,2022,01-15,23:36
039 Aiguelongue,8,0,8,2022,01-15,23:36
040 Jeu de Mail des Abbés,3,5,8,2022,01-15,23:36
041 Euromédecine,3,5,8,2022,01-15,23:36
042 Marie Caizergues,0,8,8,2022,01-15,23:36
043 Sabines,6,2,8,2022,01-15,23:36
044 Celleneuve,6,2,8,2022,01-15,23:36
045 Jardin de la Lironde,4,4,8,2022,01-15,23:36
046 Père Soulas,1,7,8,2022,01-15,23:36
047 Place Viala,4,4,8,2022,01-15,23:36
048 Hôtel du Département,2,6,8,2022,01-15,23:36
049 Tonnelles,0,8,8,2022,01-15,23:36
050 Parvis Jules Ferry - Gare Saint-Roch,4,4,8,2022,01-15,23:36
051 Pont de Lattes - Gare Saint-Roch,6,6,12,2022,01-15,23:36
053 Deux Ponts - Gare Saint-Roch,3,5,8,2022,01-15,23:36
054 Providence - Ovalie,0,8,8,2022,01-15,23:36
055 Pérols Etang de l'Or,23,45,68,2022,01-15,23:36
056 Albert 1er - Cathédrale,1,11,12,2022,01-15,23:36
057 Saint-Guilhem - Courreau,5,3,8,2022,01-15,23:36
059 Sud De France,1,7,8,2022,01-15,23:36
station_name,taken_vmag_space,free_vmag_space,total_vmag_space,year,day&month,hour&min
001 Rue Jules Ferry - Gare Saint-Roch,2,10,12,2022,01-15,23:41
002 Comédie,13,11,24,2022,01-15,23:41
003 Esplanade,2,30,32,2022,01-15,23:41
004 Hôtel de Ville,7,9,16,2022,01-15,23:41
005 Corum,9,3,12,2022,01-15,23:41
006 Place Albert 1er - St Charles,9,22,31,2022,01-15,23:41
007 Foch,1,7,8,2022,01-15,23:41
008 Halles Castellane,0,12,12,2022,01-15,23:41
009 Observatoire,8,0,8,2022,01-15,23:41
010 Rondelet,2,14,16,2022,01-15,23:41
011 Plan Cabanes,6,6,12,2022,01-15,23:41
012 Boutonnet,4,8,12,2022,01-15,23:41
013 Emile Combes,6,2,8,2022,01-15,23:41
014 Beaux-Arts,6,2,8,2022,01-15,23:41
015 Les Aubes,6,2,8,2022,01-15,23:41
016 Antigone centre,6,10,16,2022,01-15,23:41
017 Médiathèque Emile Zola,7,9,16,2022,01-15,23:41
018 Nombre d'Or,8,8,16,2022,01-15,23:41
019 Louis Blanc,4,12,16,2022,01-15,23:41
020 Gambetta,4,4,8,2022,01-15,23:41
021 Port Marianne,13,3,16,2022,01-15,23:41
022 Clemenceau,0,12,12,2022,01-15,23:41
023 Les Arceaux,7,9,16,2022,01-15,23:41
024 Cité Mion,5,3,8,2022,01-15,23:41
025 Nouveau Saint-Roch,4,4,8,2022,01-15,23:41
026 Renouvier,3,5,8,2022,01-15,23:41
027 Odysseum,6,2,8,2022,01-15,23:41
028 Saint-Denis,4,4,8,2022,01-15,23:41
029 Richter,13,3,16,2022,01-15,23:41
030 Charles Flahault,3,5,8,2022,01-15,23:41
031 Voltaire,6,2,8,2022,01-15,23:41
032 Prés d'Arènes,8,0,8,2022,01-15,23:41
033 Garcia Lorca,6,2,8,2022,01-15,23:41
034 Vert Bois,0,16,16,2022,01-15,23:41
035 Malbosc,3,5,8,2022,01-15,23:41
036 Occitanie,2,30,32,2022,01-15,23:41
037 FacdesSciences,2,22,24,2022,01-15,23:41
038 Fac de Lettres,0,16,16,2022,01-15,23:41
039 Aiguelongue,8,0,8,2022,01-15,23:41
040 Jeu de Mail des Abbés,3,5,8,2022,01-15,23:41
041 Euromédecine,3,5,8,2022,01-15,23:41
042 Marie Caizergues,0,8,8,2022,01-15,23:41
043 Sabines,6,2,8,2022,01-15,23:41
044 Celleneuve,6,2,8,2022,01-15,23:41
045 Jardin de la Lironde,4,4,8,2022,01-15,23:41
046 Père Soulas,1,7,8,2022,01-15,23:41
047 Place Viala,6,2,8,2022,01-15,23:41
048 Hôtel du Département,2,6,8,2022,01-15,23:41
049 Tonnelles,0,8,8,2022,01-15,23:41
050 Parvis Jules Ferry - Gare Saint-Roch,4,4,8,2022,01-15,23:41
051 Pont de Lattes - Gare Saint-Roch,6,6,12,2022,01-15,23:41
053 Deux Ponts - Gare Saint-Roch,3,5,8,2022,01-15,23:41
054 Providence - Ovalie,0,8,8,2022,01-15,23:41
055 Pérols Etang de l'Or,23,45,68,2022,01-15,23:41
056 Albert 1er - Cathédrale,1,11,12,2022,01-15,23:41
057 Saint-Guilhem - Courreau,5,3,8,2022,01-15,23:41
059 Sud De France,1,7,8,2022,01-15,23:41
station_name,taken_vmag_space,free_vmag_space,total_vmag_space,year,day&month,hour&min
001 Rue Jules Ferry - Gare Saint-Roch,2,10,12,2022,01-15,23:46
002 Comédie,13,11,24,2022,01-15,23:46
003 Esplanade,2,30,32,2022,01-15,23:46
004 Hôtel de Ville,7,9,16,2022,01-15,23:46
005 Corum,9,3,12,2022,01-15,23:46
006 Place Albert 1er - St Charles,9,22,31,2022,01-15,23:46
007 Foch,1,7,8,2022,01-15,23:46
008 Halles Castellane,0,12,12,2022,01-15,23:46
009 Observatoire,8,0,8,2022,01-15,23:46
010 Rondelet,2,14,16,2022,01-15,23:46
011 Plan Cabanes,6,6,12,2022,01-15,23:46
012 Boutonnet,4,8,12,2022,01-15,23:46
013 Emile Combes,6,2,8,2022,01-15,23:46
014 Beaux-Arts,6,2,8,2022,01-15,23:46
015 Les Aubes,6,2,8,2022,01-15,23:46
016 Antigone centre,6,10,16,2022,01-15,23:46
017 Médiathèque Emile Zola,7,9,16,2022,01-15,23:46
018 Nombre d'Or,8,8,16,2022,01-15,23:46
019 Louis Blanc,4,12,16,2022,01-15,23:46
020 Gambetta,4,4,8,2022,01-15,23:46
021 Port Marianne,13,3,16,2022,01-15,23:46
022 Clemenceau,0,12,12,2022,01-15,23:46
023 Les Arceaux,7,9,16,2022,01-15,23:46
024 Cité Mion,5,3,8,2022,01-15,23:46
025 Nouveau Saint-Roch,4,4,8,2022,01-15,23:46
026 Renouvier,3,5,8,2022,01-15,23:46
027 Odysseum,6,2,8,2022,01-15,23:46
028 Saint-Denis,4,4,8,2022,01-15,23:46
029 Richter,13,3,16,2022,01-15,23:46
030 Charles Flahault,3,5,8,2022,01-15,23:46
031 Voltaire,6,2,8,2022,01-15,23:46
032 Prés d'Arènes,8,0,8,2022,01-15,23:46
033 Garcia Lorca,6,2,8,2022,01-15,23:46
034 Vert Bois,0,16,16,2022,01-15,23:46
035 Malbosc,3,5,8,2022,01-15,23:46
036 Occitanie,2,30,32,2022,01-15,23:46
037 FacdesSciences,2,22,24,2022,01-15,23:46
038 Fac de Lettres,0,16,16,2022,01-15,23:46
039 Aiguelongue,8,0,8,2022,01-15,23:46
040 Jeu de Mail des Abbés,3,5,8,2022,01-15,23:46
041 Euromédecine,3,5,8,2022,01-15,23:46
042 Marie Caizergues,0,8,8,2022,01-15,23:46
043 Sabines,6,2,8,2022,01-15,23:46
044 Celleneuve,6,2,8,2022,01-15,23:46
045 Jardin de la Lironde,4,4,8,2022,01-15,23:46
046 Père Soulas,2,6,8,2022,01-15,23:46
047 Place Viala,6,2,8,2022,01-15,23:46
048 Hôtel du Département,2,6,8,2022,01-15,23:46
049 Tonnelles,0,8,8,2022,01-15,23:46
050 Parvis Jules Ferry - Gare Saint-Roch,4,4,8,2022,01-15,23:46
051 Pont de Lattes - Gare Saint-Roch,6,6,12,2022,01-15,23:46
053 Deux Ponts - Gare Saint-Roch,3,5,8,2022,01-15,23:46
054 Providence - Ovalie,0,8,8,2022,01-15,23:46
055 Pérols Etang de l'Or,23,45,68,2022,01-15,23:46
056 Albert 1er - Cathédrale,1,11,12,2022,01-15,23:46
057 Saint-Guilhem - Courreau,5,3,8,2022,01-15,23:46
059 Sud De France,1,7,8,2022,01-15,23:46
station_name,taken_vmag_space,free_vmag_space,total_vmag_space,year,day&month,hour&min
001 Rue Jules Ferry - Gare Saint-Roch,2,10,12,2022,01-15,23:51
002 Comédie,11,13,24,2022,01-15,23:51
003 Esplanade,2,30,32,2022,01-15,23:51
004 Hôtel de Ville,7,9,16,2022,01-15,23:51
005 Corum,9,3,12,2022,01-15,23:51
006 Place Albert 1er - St Charles,9,22,31,2022,01-15,23:51
007 Foch,1,7,8,2022,01-15,23:51
008 Halles Castellane,0,12,12,2022,01-15,23:51
009 Observatoire,8,0,8,2022,01-15,23:51
010 Rondelet,2,14,16,2022,01-15,23:51
011 Plan Cabanes,6,6,12,2022,01-15,23:51
012 Boutonnet,4,8,12,2022,01-15,23:51
013 Emile Combes,6,2,8,2022,01-15,23:51
014 Beaux-Arts,6,2,8,2022,01-15,23:51
015 Les Aubes,6,2,8,2022,01-15,23:51
016 Antigone centre,6,10,16,2022,01-15,23:51
017 Médiathèque Emile Zola,7,9,16,2022,01-15,23:51
018 Nombre d'Or,8,8,16,2022,01-15,23:51
019 Louis Blanc,4,12,16,2022,01-15,23:51
020 Gambetta,4,4,8,2022,01-15,23:51
021 Port Marianne,13,3,16,2022,01-15,23:51
022 Clemenceau,0,12,12,2022,01-15,23:51
023 Les Arceaux,7,9,16,2022,01-15,23:51
024 Cité Mion,5,3,8,2022,01-15,23:51
025 Nouveau Saint-Roch,4,4,8,2022,01-15,23:51
026 Renouvier,3,5,8,2022,01-15,23:51
027 Odysseum,6,2,8,2022,01-15,23:51
028 Saint-Denis,4,4,8,2022,01-15,23:51
029 Richter,13,3,16,2022,01-15,23:51
030 Charles Flahault,3,5,8,2022,01-15,23:51
031 Voltaire,6,2,8,2022,01-15,23:51
032 Prés d'Arènes,8,0,8,2022,01-15,23:51
033 Garcia Lorca,6,2,8,2022,01-15,23:51
034 Vert Bois,0,16,16,2022,01-15,23:51
035 Malbosc,3,5,8,2022,01-15,23:51
036 Occitanie,2,30,32,2022,01-15,23:51
037 FacdesSciences,6,18,24,2022,01-15,23:51
038 Fac de Lettres,0,16,16,2022,01-15,23:51
039 Aiguelongue,8,0,8,2022,01-15,23:51
040 Jeu de Mail des Abbés,3,5,8,2022,01-15,23:51
041 Euromédecine,3,5,8,2022,01-15,23:51
042 Marie Caizergues,0,8,8,2022,01-15,23:51
043 Sabines,6,2,8,2022,01-15,23:51
044 Celleneuve,6,2,8,2022,01-15,23:51
045 Jardin de la Lironde,4,4,8,2022,01-15,23:51
046 Père Soulas,2,6,8,2022,01-15,23:51
047 Place Viala,6,2,8,2022,01-15,23:51
048 Hôtel du Département,2,6,8,2022,01-15,23:51
049 Tonnelles,0,8,8,2022,01-15,23:51
050 Parvis Jules Ferry - Gare Saint-Roch,4,4,8,2022,01-15,23:51
051 Pont de Lattes - Gare Saint-Roch,6,6,12,2022,01-15,23:51
053 Deux Ponts - Gare Saint-Roch,3,5,8,2022,01-15,23:51
054 Providence - Ovalie,0,8,8,2022,01-15,23:51
055 Pérols Etang de l'Or,23,45,68,2022,01-15,23:51
056 Albert 1er - Cathédrale,1,11,12,2022,01-15,23:51
057 Saint-Guilhem - Courreau,4,4,8,2022,01-15,23:51
059 Sud De France,1,7,8,2022,01-15,23:51
station_name,taken_vmag_space,free_vmag_space,total_vmag_space,year,day&month,hour&min
001 Rue Jules Ferry - Gare Saint-Roch,2,10,12,2022,01-15,23:56
002 Comédie,11,13,24,2022,01-15,23:56
003 Esplanade,2,30,32,2022,01-15,23:56
004 Hôtel de Ville,7,9,16,2022,01-15,23:56
005 Corum,9,3,12,2022,01-15,23:56
006 Place Albert 1er - St Charles,9,22,31,2022,01-15,23:56
007 Foch,1,7,8,2022,01-15,23:56
008 Halles Castellane,0,12,12,2022,01-15,23:56
009 Observatoire,8,0,8,2022,01-15,23:56
010 Rondelet,2,14,16,2022,01-15,23:56
011 Plan Cabanes,6,6,12,2022,01-15,23:56
012 Boutonnet,4,8,12,2022,01-15,23:56
013 Emile Combes,6,2,8,2022,01-15,23:56
014 Beaux-Arts,6,2,8,2022,01-15,23:56
015 Les Aubes,6,2,8,2022,01-15,23:56
016 Antigone centre,6,10,16,2022,01-15,23:56
017 Médiathèque Emile Zola,7,9,16,2022,01-15,23:56
018 Nombre d'Or,8,8,16,2022,01-15,23:56
019 Louis Blanc,4,12,16,2022,01-15,23:56
020 Gambetta,4,4,8,2022,01-15,23:56
021 Port Marianne,13,3,16,2022,01-15,23:56
022 Clemenceau,0,12,12,2022,01-15,23:56
023 Les Arceaux,7,9,16,2022,01-15,23:56
024 Cité Mion,5,3,8,2022,01-15,23:56
025 Nouveau Saint-Roch,4,4,8,2022,01-15,23:56
026 Renouvier,3,5,8,2022,01-15,23:56
027 Odysseum,5,3,8,2022,01-15,23:56
028 Saint-Denis,4,4,8,2022,01-15,23:56
029 Richter,13,3,16,2022,01-15,23:56
030 Charles Flahault,3,5,8,2022,01-15,23:56
031 Voltaire,6,2,8,2022,01-15,23:56
032 Prés d'Arènes,8,0,8,2022,01-15,23:56
033 Garcia Lorca,6,2,8,2022,01-15,23:56
034 Vert Bois,0,16,16,2022,01-15,23:56
035 Malbosc,3,5,8,2022,01-15,23:56
036 Occitanie,2,30,32,2022,01-15,23:56
037 FacdesSciences,6,18,24,2022,01-15,23:56
038 Fac de Lettres,0,16,16,2022,01-15,23:56
039 Aiguelongue,8,0,8,2022,01-15,23:56
040 Jeu de Mail des Abbés,3,5,8,2022,01-15,23:56
041 Euromédecine,3,5,8,2022,01-15,23:56
042 Marie Caizergues,1,7,8,2022,01-15,23:56
043 Sabines,6,2,8,2022,01-15,23:56
044 Celleneuve,6,2,8,2022,01-15,23:56
045 Jardin de la Lironde,4,4,8,2022,01-15,23:56
046 Père Soulas,2,6,8,2022,01-15,23:56
047 Place Viala,6,2,8,2022,01-15,23:56
048 Hôtel du Département,2,6,8,2022,01-15,23:56
049 Tonnelles,0,8,8,2022,01-15,23:56
050 Parvis Jules Ferry - Gare Saint-Roch,4,4,8,2022,01-15,23:56
051 Pont de Lattes - Gare Saint-Roch,6,6,12,2022,01-15,23:56
053 Deux Ponts - Gare Saint-Roch,3,5,8,2022,01-15,23:56
054 Providence - Ovalie,0,8,8,2022,01-15,23:56
055 Pérols Etang de l'Or,23,45,68,2022,01-15,23:56
056 Albert 1er - Cathédrale,1,11,12,2022,01-15,23:56
057 Saint-Guilhem - Courreau,4,4,8,2022,01-15,23:56
059 Sud De France,1,7,8,2022,01-15,23:56
station_name,taken_vmag_space,free_vmag_space,total_vmag_space,year,day&month,hour&min
001 Rue Jules Ferry - Gare Saint-Roch,2,10,12,2022,01-16,00:01
002 Comédie,11,13,24,2022,01-16,00:01
003 Esplanade,2,30,32,2022,01-16,00:01
004 Hôtel de Ville,7,9,16,2022,01-16,00:01
005 Corum,9,3,12,2022,01-16,00:01
006 Place Albert 1er - St Charles,9,22,31,2022,01-16,00:01
007 Foch,1,7,8,2022,01-16,00:01
008 Halles Castellane,0,12,12,2022,01-16,00:01
009 Observatoire,8,0,8,2022,01-16,00:01
010 Rondelet,2,14,16,2022,01-16,00:01
011 Plan Cabanes,6,6,12,2022,01-16,00:01
012 Boutonnet,4,8,12,2022,01-16,00:01
013 Emile Combes,6,2,8,2022,01-16,00:01
014 Beaux-Arts,6,2,8,2022,01-16,00:01
015 Les Aubes,6,2,8,2022,01-16,00:01
016 Antigone centre,6,10,16,2022,01-16,00:01
017 Médiathèque Emile Zola,7,9,16,2022,01-16,00:01
018 Nombre d'Or,8,8,16,2022,01-16,00:01
019 Louis Blanc,4,12,16,2022,01-16,00:01
020 Gambetta,4,4,8,2022,01-16,00:01
021 Port Marianne,13,3,16,2022,01-16,00:01
022 Clemenceau,0,12,12,2022,01-16,00:01
023 Les Arceaux,7,9,16,2022,01-16,00:01
024 Cité Mion,5,3,8,2022,01-16,00:01
025 Nouveau Saint-Roch,4,4,8,2022,01-16,00:01
026 Renouvier,3,5,8,2022,01-16,00:01
027 Odysseum,4,4,8,2022,01-16,00:01
028 Saint-Denis,4,4,8,2022,01-16,00:01
029 Richter,13,3,16,2022,01-16,00:01
030 Charles Flahault,3,5,8,2022,01-16,00:01
031 Voltaire,6,2,8,2022,01-16,00:01
032 Prés d'Arènes,8,0,8,2022,01-16,00:01
033 Garcia Lorca,6,2,8,2022,01-16,00:01
034 Vert Bois,0,16,16,2022,01-16,00:01
035 Malbosc,3,5,8,2022,01-16,00:01
036 Occitanie,2,30,32,2022,01-16,00:01
037 FacdesSciences,6,18,24,2022,01-16,00:01
038 Fac de Lettres,0,16,16,2022,01-16,00:01
039 Aiguelongue,8,0,8,2022,01-16,00:01
040 Jeu de Mail des Abbés,3,5,8,2022,01-16,00:01
041 Euromédecine,3,5,8,2022,01-16,00:01
042 Marie Caizergues,1,7,8,2022,01-16,00:01
043 Sabines,6,2,8,2022,01-16,00:01
044 Celleneuve,6,2,8,2022,01-16,00:01
045 Jardin de la Lironde,4,4,8,2022,01-16,00:01
046 Père Soulas,2,6,8,2022,01-16,00:01
047 Place Viala,7,1,8,2022,01-16,00:01
048 Hôtel du Département,2,6,8,2022,01-16,00:01
049 Tonnelles,0,8,8,2022,01-16,00:01
050 Parvis Jules Ferry - Gare Saint-Roch,4,4,8,2022,01-16,00:01
051 Pont de Lattes - Gare Saint-Roch,6,6,12,2022,01-16,00:01
053 Deux Ponts - Gare Saint-Roch,3,5,8,2022,01-16,00:01
054 Providence - Ovalie,0,8,8,2022,01-16,00:01
055 Pérols Etang de l'Or,23,45,68,2022,01-16,00:01
056 Albert 1er - Cathédrale,1,11,12,2022,01-16,00:01
057 Saint-Guilhem - Courreau,4,4,8,2022,01-16,00:01
059 Sud De France,1,7,8,2022,01-16,00:01
station_name,taken_vmag_space,free_vmag_space,total_vmag_space,year,day&month,hour&min
001 Rue Jules Ferry - Gare Saint-Roch,2,10,12,2022,01-16,00:06
002 Comédie,10,14,24,2022,01-16,00:06
003 Esplanade,2,30,32,2022,01-16,00:06
004 Hôtel de Ville,7,9,16,2022,01-16,00:06
005 Corum,9,3,12,2022,01-16,00:06
006 Place Albert 1er - St Charles,9,22,31,2022,01-16,00:06
007 Foch,1,7,8,2022,01-16,00:06
008 Halles Castellane,0,12,12,2022,01-16,00:06
009 Observatoire,8,0,8,2022,01-16,00:06
010 Rondelet,2,14,16,2022,01-16,00:06
011 Plan Cabanes,6,6,12,2022,01-16,00:06
012 Boutonnet,4,8,12,2022,01-16,00:06
013 Emile Combes,6,2,8,2022,01-16,00:06
014 Beaux-Arts,6,2,8,2022,01-16,00:06
015 Les Aubes,6,2,8,2022,01-16,00:06
016 Antigone centre,6,10,16,2022,01-16,00:06
017 Médiathèque Emile Zola,7,9,16,2022,01-16,00:06
018 Nombre d'Or,8,8,16,2022,01-16,00:06
019 Louis Blanc,4,12,16,2022,01-16,00:06
020 Gambetta,4,4,8,2022,01-16,00:06
021 Port Marianne,13,3,16,2022,01-16,00:06
022 Clemenceau,0,12,12,2022,01-16,00:06
023 Les Arceaux,7,9,16,2022,01-16,00:06
024 Cité Mion,5,3,8,2022,01-16,00:06
025 Nouveau Saint-Roch,4,4,8,2022,01-16,00:06
026 Renouvier,3,5,8,2022,01-16,00:06
027 Odysseum,4,4,8,2022,01-16,00:06
028 Saint-Denis,4,4,8,2022,01-16,00:06
029 Richter,13,3,16,2022,01-16,00:06
030 Charles Flahault,3,5,8,2022,01-16,00:06
031 Voltaire,6,2,8,2022,01-16,00:06
032 Prés d'Arènes,8,0,8,2022,01-16,00:06
033 Garcia Lorca,6,2,8,2022,01-16,00:06
034 Vert Bois,0,16,16,2022,01-16,00:06
035 Malbosc,3,5,8,2022,01-16,00:06
036 Occitanie,2,30,32,2022,01-16,00:06
037 FacdesSciences,6,18,24,2022,01-16,00:06
038 Fac de Lettres,0,16,16,2022,01-16,00:06
039 Aiguelongue,8,0,8,2022,01-16,00:06
040 Jeu de Mail des Abbés,3,5,8,2022,01-16,00:06
041 Euromédecine,3,5,8,2022,01-16,00:06
042 Marie Caizergues,1,7,8,2022,01-16,00:06
043 Sabines,6,2,8,2022,01-16,00:06
044 Celleneuve,5,3,8,2022,01-16,00:06
045 Jardin de la Lironde,4,4,8,2022,01-16,00:06
046 Père Soulas,2,6,8,2022,01-16,00:06
047 Place Viala,7,1,8,2022,01-16,00:06
048 Hôtel du Département,2,6,8,2022,01-16,00:06
049 Tonnelles,0,8,8,2022,01-16,00:06
050 Parvis Jules Ferry - Gare Saint-Roch,4,4,8,2022,01-16,00:06
051 Pont de Lattes - Gare Saint-Roch,6,6,12,2022,01-16,00:06
053 Deux Ponts - Gare Saint-Roch,3,5,8,2022,01-16,00:06
054 Providence - Ovalie,0,8,8,2022,01-16,00:06
055 Pérols Etang de l'Or,23,45,68,2022,01-16,00:06
056 Albert 1er - Cathédrale,1,11,12,2022,01-16,00:06
057 Saint-Guilhem - Courreau,4,4,8,2022,01-16,00:06
059 Sud De France,1,7,8,2022,01-16,00:06
station_name,taken_vmag_space,free_vmag_space,total_vmag_space,year,day&month,hour&min
001 Rue Jules Ferry - Gare Saint-Roch,2,10,12,2022,01-16,00:11
002 Comédie,9,15,24,2022,01-16,00:11
003 Esplanade,2,30,32,2022,01-16,00:11
004 Hôtel de Ville,7,9,16,2022,01-16,00:11
005 Corum,9,3,12,2022,01-16,00:11
006 Place Albert 1er - St Charles,9,22,31,2022,01-16,00:11
007 Foch,1,7,8,2022,01-16,00:11
008 Halles Castellane,0,12,12,2022,01-16,00:11
009 Observatoire,8,0,8,2022,01-16,00:11
010 Rondelet,2,14,16,2022,01-16,00:11
011 Plan Cabanes,6,6,12,2022,01-16,00:11
012 Boutonnet,4,8,12,2022,01-16,00:11
013 Emile Combes,6,2,8,2022,01-16,00:11
014 Beaux-Arts,6,2,8,2022,01-16,00:11
015 Les Aubes,6,2,8,2022,01-16,00:11
016 Antigone centre,6,10,16,2022,01-16,00:11
017 Médiathèque Emile Zola,7,9,16,2022,01-16,00:11
018 Nombre d'Or,8,8,16,2022,01-16,00:11
019 Louis Blanc,4,12,16,2022,01-16,00:11
020 Gambetta,4,4,8,2022,01-16,00:11
021 Port Marianne,13,3,16,2022,01-16,00:11
022 Clemenceau,0,12,12,2022,01-16,00:11
023 Les Arceaux,7,9,16,2022,01-16,00:11
024 Cité Mion,5,3,8,2022,01-16,00:11
025 Nouveau Saint-Roch,4,4,8,2022,01-16,00:11
026 Renouvier,3,5,8,2022,01-16,00:11
027 Odysseum,4,4,8,2022,01-16,00:11
028 Saint-Denis,4,4,8,2022,01-16,00:11
029 Richter,13,3,16,2022,01-16,00:11
030 Charles Flahault,3,5,8,2022,01-16,00:11
031 Voltaire,6,2,8,2022,01-16,00:11
032 Prés d'Arènes,8,0,8,2022,01-16,00:11
033 Garcia Lorca,6,2,8,2022,01-16,00:11
034 Vert Bois,0,16,16,2022,01-16,00:11
035 Malbosc,3,5,8,2022,01-16,00:11
036 Occitanie,2,30,32,2022,01-16,00:11
037 FacdesSciences,6,18,24,2022,01-16,00:11
038 Fac de Lettres,0,16,16,2022,01-16,00:11
039 Aiguelongue,8,0,8,2022,01-16,00:11
040 Jeu de Mail des Abbés,3,5,8,2022,01-16,00:11
041 Euromédecine,3,5,8,2022,01-16,00:11
042 Marie Caizergues,1,7,8,2022,01-16,00:11
043 Sabines,6,2,8,2022,01-16,00:11
044 Celleneuve,5,3,8,2022,01-16,00:11
045 Jardin de la Lironde,4,4,8,2022,01-16,00:11
046 Père Soulas,2,6,8,2022,01-16,00:11
047 Place Viala,7,1,8,2022,01-16,00:11
048 Hôtel du Département,2,6,8,2022,01-16,00:11
049 Tonnelles,0,8,8,2022,01-16,00:11
050 Parvis Jules Ferry - Gare Saint-Roch,4,4,8,2022,01-16,00:11
051 Pont de Lattes - Gare Saint-Roch,6,6,12,2022,01-16,00:11
053 Deux Ponts - Gare Saint-Roch,3,5,8,2022,01-16,00:11
054 Providence - Ovalie,0,8,8,2022,01-16,00:11
055 Pérols Etang de l'Or,23,45,68,2022,01-16,00:11
056 Albert 1er - Cathédrale,1,11,12,2022,01-16,00:11
057 Saint-Guilhem - Courreau,4,4,8,2022,01-16,00:11
059 Sud De France,1,7,8,2022,01-16,00:11
station_name,taken_vmag_space,free_vmag_space,total_vmag_space,year,day&month,hour&min
001 Rue Jules Ferry - Gare Saint-Roch,2,10,12,2022,01-16,00:16
002 Comédie,9,15,24,2022,01-16,00:16
003 Esplanade,2,30,32,2022,01-16,00:16
004 Hôtel de Ville,7,9,16,2022,01-16,00:16
005 Corum,8,4,12,2022,01-16,00:16
006 Place Albert 1er - St Charles,9,22,31,2022,01-16,00:16
007 Foch,1,7,8,2022,01-16,00:16
008 Halles Castellane,0,12,12,2022,01-16,00:16
009 Observatoire,8,0,8,2022,01-16,00:16
010 Rondelet,2,14,16,2022,01-16,00:16
011 Plan Cabanes,6,6,12,2022,01-16,00:16
012 Boutonnet,4,8,12,2022,01-16,00:16
013 Emile Combes,6,2,8,2022,01-16,00:16
014 Beaux-Arts,6,2,8,2022,01-16,00:16
015 Les Aubes,6,2,8,2022,01-16,00:16
016 Antigone centre,6,10,16,2022,01-16,00:16
017 Médiathèque Emile Zola,7,9,16,2022,01-16,00:16
018 Nombre d'Or,8,8,16,2022,01-16,00:16
019 Louis Blanc,4,12,16,2022,01-16,00:16
020 Gambetta,4,4,8,2022,01-16,00:16
021 Port Marianne,13,3,16,2022,01-16,00:16
022 Clemenceau,0,12,12,2022,01-16,00:16
023 Les Arceaux,7,9,16,2022,01-16,00:16
024 Cité Mion,5,3,8,2022,01-16,00:16
025 Nouveau Saint-Roch,4,4,8,2022,01-16,00:16
026 Renouvier,3,5,8,2022,01-16,00:16
027 Odysseum,4,4,8,2022,01-16,00:16
028 Saint-Denis,4,4,8,2022,01-16,00:16
029 Richter,13,3,16,2022,01-16,00:16
030 Charles Flahault,3,5,8,2022,01-16,00:16
031 Voltaire,6,2,8,2022,01-16,00:16
032 Prés d'Arènes,8,0,8,2022,01-16,00:16
033 Garcia Lorca,6,2,8,2022,01-16,00:16
034 Vert Bois,0,16,16,2022,01-16,00:16
035 Malbosc,3,5,8,2022,01-16,00:16
036 Occitanie,2,30,32,2022,01-16,00:16
037 FacdesSciences,6,18,24,2022,01-16,00:16
038 Fac de Lettres,0,16,16,2022,01-16,00:16
039 Aiguelongue,8,0,8,2022,01-16,00:16
040 Jeu de Mail des Abbés,3,5,8,2022,01-16,00:16
041 Euromédecine,3,5,8,2022,01-16,00:16
042 Marie Caizergues,1,7,8,2022,01-16,00:16
043 Sabines,6,2,8,2022,01-16,00:16
044 Celleneuve,5,3,8,2022,01-16,00:16
045 Jardin de la Lironde,4,4,8,2022,01-16,00:16
046 Père Soulas,2,6,8,2022,01-16,00:16
047 Place Viala,6,2,8,2022,01-16,00:16
048 Hôtel du Département,2,6,8,2022,01-16,00:16
049 Tonnelles,1,7,8,2022,01-16,00:16
050 Parvis Jules Ferry - Gare Saint-Roch,4,4,8,2022,01-16,00:16
051 Pont de Lattes - Gare Saint-Roch,6,6,12,2022,01-16,00:16
053 Deux Ponts - Gare Saint-Roch,3,5,8,2022,01-16,00:16
054 Providence - Ovalie,0,8,8,2022,01-16,00:16
055 Pérols Etang de l'Or,23,45,68,2022,01-16,00:16
056 Albert 1er - Cathédrale,1,11,12,2022,01-16,00:16
057 Saint-Guilhem - Courreau,4,4,8,2022,01-16,00:16
059 Sud De France,1,7,8,2022,01-16,00:16
station_name,taken_vmag_space,free_vmag_space,total_vmag_space,year,day&month,hour&min
001 Rue Jules Ferry - Gare Saint-Roch,2,10,12,2022,01-16,00:21
002 Comédie,9,15,24,2022,01-16,00:21
003 Esplanade,2,30,32,2022,01-16,00:21
004 Hôtel de Ville,7,9,16,2022,01-16,00:21
005 Corum,8,4,12,2022,01-16,00:21
006 Place Albert 1er - St Charles,10,21,31,2022,01-16,00:21
007 Foch,1,7,8,2022,01-16,00:21
008 Halles Castellane,0,12,12,2022,01-16,00:21
009 Observatoire,8,0,8,2022,01-16,00:21
010 Rondelet,2,14,16,2022,01-16,00:21
011 Plan Cabanes,6,6,12,2022,01-16,00:21
012 Boutonnet,3,9,12,2022,01-16,00:21
013 Emile Combes,6,2,8,2022,01-16,00:21
014 Beaux-Arts,6,2,8,2022,01-16,00:21
015 Les Aubes,8,0,8,2022,01-16,00:21
016 Antigone centre,6,10,16,2022,01-16,00:21
017 Médiathèque Emile Zola,7,9,16,2022,01-16,00:21
018 Nombre d'Or,8,8,16,2022,01-16,00:21
019 Louis Blanc,3,13,16,2022,01-16,00:21
020 Gambetta,4,4,8,2022,01-16,00:21
021 Port Marianne,13,3,16,2022,01-16,00:21
022 Clemenceau,0,12,12,2022,01-16,00:21
023 Les Arceaux,10,6,16,2022,01-16,00:21
024 Cité Mion,5,3,8,2022,01-16,00:21
025 Nouveau Saint-Roch,4,4,8,2022,01-16,00:21
026 Renouvier,3,5,8,2022,01-16,00:21
027 Odysseum,4,4,8,2022,01-16,00:21
028 Saint-Denis,4,4,8,2022,01-16,00:21
029 Richter,13,3,16,2022,01-16,00:21
030 Charles Flahault,3,5,8,2022,01-16,00:21
031 Voltaire,8,0,8,2022,01-16,00:21
032 Prés d'Arènes,8,0,8,2022,01-16,00:21
033 Garcia Lorca,6,2,8,2022,01-16,00:21
034 Vert Bois,0,16,16,2022,01-16,00:21
035 Malbosc,3,5,8,2022,01-16,00:21
036 Occitanie,2,30,32,2022,01-16,00:21
037 FacdesSciences,6,18,24,2022,01-16,00:21
038 Fac de Lettres,0,16,16,2022,01-16,00:21
039 Aiguelongue,8,0,8,2022,01-16,00:21
040 Jeu de Mail des Abbés,3,5,8,2022,01-16,00:21
041 Euromédecine,3,5,8,2022,01-16,00:21
042 Marie Caizergues,1,7,8,2022,01-16,00:21
043 Sabines,6,2,8,2022,01-16,00:21
044 Celleneuve,5,3,8,2022,01-16,00:21
045 Jardin de la Lironde,4,4,8,2022,01-16,00:21
046 Père Soulas,2,6,8,2022,01-16,00:21
047 Place Viala,4,4,8,2022,01-16,00:21
048 Hôtel du Département,2,6,8,2022,01-16,00:21
049 Tonnelles,1,7,8,2022,01-16,00:21
050 Parvis Jules Ferry - Gare Saint-Roch,4,4,8,2022,01-16,00:21
051 Pont de Lattes - Gare Saint-Roch,6,6,12,2022,01-16,00:21
053 Deux Ponts - Gare Saint-Roch,3,5,8,2022,01-16,00:21
054 Providence - Ovalie,0,8,8,2022,01-16,00:21
055 Pérols Etang de l'Or,23,45,68,2022,01-16,00:21
056 Albert 1er - Cathédrale,1,11,12,2022,01-16,00:21
057 Saint-Guilhem - Courreau,4,4,8,2022,01-16,00:21
059 Sud De France,1,7,8,2022,01-16,00:21
station_name,taken_vmag_space,free_vmag_space,total_vmag_space,year,day&month,hour&min
001 Rue Jules Ferry - Gare Saint-Roch,2,10,12,2022,01-16,00:31
002 Comédie,9,15,24,2022,01-16,00:31
003 Esplanade,2,30,32,2022,01-16,00:31
004 Hôtel de Ville,7,9,16,2022,01-16,00:31
005 Corum,8,4,12,2022,01-16,00:31
006 Place Albert 1er - St Charles,10,21,31,2022,01-16,00:31
007 Foch,1,7,8,2022,01-16,00:31
008 Halles Castellane,0,12,12,2022,01-16,00:31
009 Observatoire,8,0,8,2022,01-16,00:31
010 Rondelet,2,14,16,2022,01-16,00:31
011 Plan Cabanes,6,6,12,2022,01-16,00:31
012 Boutonnet,3,9,12,2022,01-16,00:31
013 Emile Combes,5,3,8,2022,01-16,00:31
014 Beaux-Arts,6,2,8,2022,01-16,00:31
015 Les Aubes,8,0,8,2022,01-16,00:31
016 Antigone centre,6,10,16,2022,01-16,00:31
017 Médiathèque Emile Zola,7,9,16,2022,01-16,00:31
018 Nombre d'Or,8,8,16,2022,01-16,00:31
019 Louis Blanc,5,11,16,2022,01-16,00:31
020 Gambetta,4,4,8,2022,01-16,00:31
021 Port Marianne,13,3,16,2022,01-16,00:31
022 Clemenceau,0,12,12,2022,01-16,00:31
023 Les Arceaux,10,6,16,2022,01-16,00:31
024 Cité Mion,5,3,8,2022,01-16,00:31
025 Nouveau Saint-Roch,4,4,8,2022,01-16,00:31
026 Renouvier,3,5,8,2022,01-16,00:31
027 Odysseum,4,4,8,2022,01-16,00:31
028 Saint-Denis,4,4,8,2022,01-16,00:31
029 Richter,13,3,16,2022,01-16,00:31
030 Charles Flahault,3,5,8,2022,01-16,00:31
031 Voltaire,8,0,8,2022,01-16,00:31
032 Prés d'Arènes,8,0,8,2022,01-16,00:31
033 Garcia Lorca,6,2,8,2022,01-16,00:31
034 Vert Bois,0,16,16,2022,01-16,00:31
035 Malbosc,3,5,8,2022,01-16,00:31
036 Occitanie,2,30,32,2022,01-16,00:31
037 FacdesSciences,6,18,24,2022,01-16,00:31
038 Fac de Lettres,0,16,16,2022,01-16,00:31
039 Aiguelongue,8,0,8,2022,01-16,00:31
040 Jeu de Mail des Abbés,3,5,8,2022,01-16,00:31
041 Euromédecine,3,5,8,2022,01-16,00:31
042 Marie Caizergues,1,7,8,2022,01-16,00:31
043 Sabines,6,2,8,2022,01-16,00:31
044 Celleneuve,5,3,8,2022,01-16,00:31
045 Jardin de la Lironde,4,4,8,2022,01-16,00:31
046 Père Soulas,2,6,8,2022,01-16,00:31
047 Place Viala,5,3,8,2022,01-16,00:31
048 Hôtel du Département,2,6,8,2022,01-16,00:31
049 Tonnelles,1,7,8,2022,01-16,00:31
050 Parvis Jules Ferry - Gare Saint-Roch,4,4,8,2022,01-16,00:31
051 Pont de Lattes - Gare Saint-Roch,6,6,12,2022,01-16,00:31
053 Deux Ponts - Gare Saint-Roch,3,5,8,2022,01-16,00:31
054 Providence - Ovalie,0,8,8,2022,01-16,00:31
055 Pérols Etang de l'Or,23,45,68,2022,01-16,00:31
056 Albert 1er - Cathédrale,1,11,12,2022,01-16,00:31
057 Saint-Guilhem - Courreau,4,4,8,2022,01-16,00:31
059 Sud De France,1,7,8,2022,01-16,00:31
station_name,taken_vmag_space,free_vmag_space,total_vmag_space,year,day&month,hour&min
001 Rue Jules Ferry - Gare Saint-Roch,2,10,12,2022,01-16,00:35
002 Comédie,9,15,24,2022,01-16,00:35
003 Esplanade,2,30,32,2022,01-16,00:35
004 Hôtel de Ville,7,9,16,2022,01-16,00:35
005 Corum,8,4,12,2022,01-16,00:35
006 Place Albert 1er - St Charles,10,21,31,2022,01-16,00:35
007 Foch,1,7,8,2022,01-16,00:35
008 Halles Castellane,0,12,12,2022,01-16,00:35
009 Observatoire,8,0,8,2022,01-16,00:35
010 Rondelet,2,14,16,2022,01-16,00:35
011 Plan Cabanes,6,6,12,2022,01-16,00:35
012 Boutonnet,3,9,12,2022,01-16,00:35
013 Emile Combes,5,3,8,2022,01-16,00:35
014 Beaux-Arts,6,2,8,2022,01-16,00:35
015 Les Aubes,8,0,8,2022,01-16,00:35
016 Antigone centre,6,10,16,2022,01-16,00:35
017 Médiathèque Emile Zola,7,9,16,2022,01-16,00:35
018 Nombre d'Or,8,8,16,2022,01-16,00:35
019 Louis Blanc,5,11,16,2022,01-16,00:35
020 Gambetta,4,4,8,2022,01-16,00:35
021 Port Marianne,13,3,16,2022,01-16,00:35
022 Clemenceau,0,12,12,2022,01-16,00:35
023 Les Arceaux,10,6,16,2022,01-16,00:35
024 Cité Mion,5,3,8,2022,01-16,00:35
025 Nouveau Saint-Roch,4,4,8,2022,01-16,00:35
026 Renouvier,3,5,8,2022,01-16,00:35
027 Odysseum,4,4,8,2022,01-16,00:35
028 Saint-Denis,4,4,8,2022,01-16,00:35
029 Richter,13,3,16,2022,01-16,00:35
030 Charles Flahault,3,5,8,2022,01-16,00:35
031 Voltaire,8,0,8,2022,01-16,00:35
032 Prés d'Arènes,8,0,8,2022,01-16,00:35
033 Garcia Lorca,6,2,8,2022,01-16,00:35
034 Vert Bois,0,16,16,2022,01-16,00:35
035 Malbosc,3,5,8,2022,01-16,00:35
036 Occitanie,2,30,32,2022,01-16,00:35
037 FacdesSciences,6,18,24,2022,01-16,00:35
038 Fac de Lettres,0,16,16,2022,01-16,00:35
039 Aiguelongue,8,0,8,2022,01-16,00:35
040 Jeu de Mail des Abbés,3,5,8,2022,01-16,00:35
041 Euromédecine,3,5,8,2022,01-16,00:35
042 Marie Caizergues,1,7,8,2022,01-16,00:35
043 Sabines,6,2,8,2022,01-16,00:35
044 Celleneuve,5,3,8,2022,01-16,00:35
045 Jardin de la Lironde,4,4,8,2022,01-16,00:35
046 Père Soulas,2,6,8,2022,01-16,00:35
047 Place Viala,5,3,8,2022,01-16,00:35
048 Hôtel du Département,2,6,8,2022,01-16,00:35
049 Tonnelles,1,7,8,2022,01-16,00:35
050 Parvis Jules Ferry - Gare Saint-Roch,4,4,8,2022,01-16,00:35
051 Pont de Lattes - Gare Saint-Roch,6,6,12,2022,01-16,00:35
053 Deux Ponts - Gare Saint-Roch,3,5,8,2022,01-16,00:35
054 Providence - Ovalie,0,8,8,2022,01-16,00:35
055 Pérols Etang de l'Or,23,45,68,2022,01-16,00:35
056 Albert 1er - Cathédrale,1,11,12,2022,01-16,00:35
057 Saint-Guilhem - Courreau,4,4,8,2022,01-16,00:35
059 Sud De France,1,7,8,2022,01-16,00:35
station_name,taken_vmag_space,free_vmag_space,total_vmag_space,year,day&month,hour&min
001 Rue Jules Ferry - Gare Saint-Roch,2,10,12,2022,01-16,00:43
002 Comédie,8,16,24,2022,01-16,00:43
003 Esplanade,2,30,32,2022,01-16,00:43
004 Hôtel de Ville,7,9,16,2022,01-16,00:43
005 Corum,8,4,12,2022,01-16,00:43
006 Place Albert 1er - St Charles,10,21,31,2022,01-16,00:43
007 Foch,1,7,8,2022,01-16,00:43
008 Halles Castellane,0,12,12,2022,01-16,00:43
009 Observatoire,2,6,8,2022,01-16,00:43
010 Rondelet,2,14,16,2022,01-16,00:43
011 Plan Cabanes,5,7,12,2022,01-16,00:43
012 Boutonnet,3,9,12,2022,01-16,00:43
013 Emile Combes,5,3,8,2022,01-16,00:43
014 Beaux-Arts,6,2,8,2022,01-16,00:43
015 Les Aubes,8,0,8,2022,01-16,00:43
016 Antigone centre,6,10,16,2022,01-16,00:43
017 Médiathèque Emile Zola,7,9,16,2022,01-16,00:43
018 Nombre d'Or,8,8,16,2022,01-16,00:43
019 Louis Blanc,5,11,16,2022,01-16,00:43
020 Gambetta,4,4,8,2022,01-16,00:43
021 Port Marianne,13,3,16,2022,01-16,00:43
022 Clemenceau,0,12,12,2022,01-16,00:43
023 Les Arceaux,10,6,16,2022,01-16,00:43
024 Cité Mion,5,3,8,2022,01-16,00:43
025 Nouveau Saint-Roch,4,4,8,2022,01-16,00:43
026 Renouvier,3,5,8,2022,01-16,00:43
027 Odysseum,4,4,8,2022,01-16,00:43
028 Saint-Denis,4,4,8,2022,01-16,00:43
029 Richter,13,3,16,2022,01-16,00:43
030 Charles Flahault,3,5,8,2022,01-16,00:43
031 Voltaire,7,1,8,2022,01-16,00:43
032 Prés d'Arènes,8,0,8,2022,01-16,00:43
033 Garcia Lorca,6,2,8,2022,01-16,00:43
034 Vert Bois,0,16,16,2022,01-16,00:43
035 Malbosc,3,5,8,2022,01-16,00:43
036 Occitanie,2,30,32,2022,01-16,00:43
037 FacdesSciences,7,17,24,2022,01-16,00:43
038 Fac de Lettres,0,16,16,2022,01-16,00:43
039 Aiguelongue,8,0,8,2022,01-16,00:43
040 Jeu de Mail des Abbés,3,5,8,2022,01-16,00:43
041 Euromédecine,3,5,8,2022,01-16,00:43
042 Marie Caizergues,1,7,8,2022,01-16,00:43
043 Sabines,6,2,8,2022,01-16,00:43
044 Celleneuve,5,3,8,2022,01-16,00:43
045 Jardin de la Lironde,4,4,8,2022,01-16,00:43
046 Père Soulas,2,6,8,2022,01-16,00:43
047 Place Viala,5,3,8,2022,01-16,00:43
048 Hôtel du Département,2,6,8,2022,01-16,00:43
049 Tonnelles,1,7,8,2022,01-16,00:43
050 Parvis Jules Ferry - Gare Saint-Roch,4,4,8,2022,01-16,00:43
051 Pont de Lattes - Gare Saint-Roch,6,6,12,2022,01-16,00:43
053 Deux Ponts - Gare Saint-Roch,3,5,8,2022,01-16,00:43
054 Providence - Ovalie,0,8,8,2022,01-16,00:43
055 Pérols Etang de l'Or,23,45,68,2022,01-16,00:43
056 Albert 1er - Cathédrale,1,11,12,2022,01-16,00:43
057 Saint-Guilhem - Courreau,4,4,8,2022,01-16,00:43
059 Sud De France,1,7,8,2022,01-16,00:43
station_name,taken_vmag_space,free_vmag_space,total_vmag_space,year,day&month,hour&min
001 Rue Jules Ferry - Gare Saint-Roch,2,10,12,2022,01-16,00:43
002 Comédie,8,16,24,2022,01-16,00:43
003 Esplanade,2,30,32,2022,01-16,00:43
004 Hôtel de Ville,7,9,16,2022,01-16,00:43
005 Corum,8,4,12,2022,01-16,00:43
006 Place Albert 1er - St Charles,10,21,31,2022,01-16,00:43
007 Foch,1,7,8,2022,01-16,00:43
008 Halles Castellane,0,12,12,2022,01-16,00:43
009 Observatoire,2,6,8,2022,01-16,00:43
010 Rondelet,2,14,16,2022,01-16,00:43
011 Plan Cabanes,5,7,12,2022,01-16,00:43
012 Boutonnet,3,9,12,2022,01-16,00:43
013 Emile Combes,5,3,8,2022,01-16,00:43
014 Beaux-Arts,6,2,8,2022,01-16,00:43
015 Les Aubes,8,0,8,2022,01-16,00:43
016 Antigone centre,6,10,16,2022,01-16,00:43
017 Médiathèque Emile Zola,7,9,16,2022,01-16,00:43
018 Nombre d'Or,8,8,16,2022,01-16,00:43
019 Louis Blanc,5,11,16,2022,01-16,00:43
020 Gambetta,4,4,8,2022,01-16,00:43
021 Port Marianne,13,3,16,2022,01-16,00:43
022 Clemenceau,0,12,12,2022,01-16,00:43
023 Les Arceaux,10,6,16,2022,01-16,00:43
024 Cité Mion,5,3,8,2022,01-16,00:43
025 Nouveau Saint-Roch,4,4,8,2022,01-16,00:43
026 Renouvier,3,5,8,2022,01-16,00:43
027 Odysseum,4,4,8,2022,01-16,00:43
028 Saint-Denis,4,4,8,2022,01-16,00:43
029 Richter,13,3,16,2022,01-16,00:43
030 Charles Flahault,3,5,8,2022,01-16,00:43
031 Voltaire,7,1,8,2022,01-16,00:43
032 Prés d'Arènes,8,0,8,2022,01-16,00:43
033 Garcia Lorca,6,2,8,2022,01-16,00:43
034 Vert Bois,0,16,16,2022,01-16,00:43
035 Malbosc,3,5,8,2022,01-16,00:43
036 Occitanie,2,30,32,2022,01-16,00:43
037 FacdesSciences,7,17,24,2022,01-16,00:43
038 Fac de Lettres,0,16,16,2022,01-16,00:43
039 Aiguelongue,8,0,8,2022,01-16,00:43
040 Jeu de Mail des Abbés,3,5,8,2022,01-16,00:43
041 Euromédecine,3,5,8,2022,01-16,00:43
042 Marie Caizergues,1,7,8,2022,01-16,00:43
043 Sabines,6,2,8,2022,01-16,00:43
044 Celleneuve,5,3,8,2022,01-16,00:43
045 Jardin de la Lironde,4,4,8,2022,01-16,00:43
046 Père Soulas,2,6,8,2022,01-16,00:43
047 Place Viala,5,3,8,2022,01-16,00:43
048 Hôtel du Département,2,6,8,2022,01-16,00:43
049 Tonnelles,1,7,8,2022,01-16,00:43
050 Parvis Jules Ferry - Gare Saint-Roch,4,4,8,2022,01-16,00:43
051 Pont de Lattes - Gare Saint-Roch,6,6,12,2022,01-16,00:43
053 Deux Ponts - Gare Saint-Roch,3,5,8,2022,01-16,00:43
054 Providence - Ovalie,0,8,8,2022,01-16,00:43
055 Pérols Etang de l'Or,23,45,68,2022,01-16,00:43
056 Albert 1er - Cathédrale,1,11,12,2022,01-16,00:43
057 Saint-Guilhem - Courreau,4,4,8,2022,01-16,00:43
059 Sud De France,1,7,8,2022,01-16,00:43
station_name,taken_vmag_space,free_vmag_space,total_vmag_space,year,day&month,hour&min
001 Rue Jules Ferry - Gare Saint-Roch,2,10,12,2022,01-16,00:44
002 Comédie,8,16,24,2022,01-16,00:44
003 Esplanade,2,30,32,2022,01-16,00:44
004 Hôtel de Ville,7,9,16,2022,01-16,00:44
005 Corum,8,4,12,2022,01-16,00:44
006 Place Albert 1er - St Charles,10,21,31,2022,01-16,00:44
007 Foch,1,7,8,2022,01-16,00:44
008 Halles Castellane,0,12,12,2022,01-16,00:44
009 Observatoire,2,6,8,2022,01-16,00:44
010 Rondelet,2,14,16,2022,01-16,00:44
011 Plan Cabanes,5,7,12,2022,01-16,00:44
012 Boutonnet,3,9,12,2022,01-16,00:44
013 Emile Combes,5,3,8,2022,01-16,00:44
014 Beaux-Arts,6,2,8,2022,01-16,00:44
015 Les Aubes,8,0,8,2022,01-16,00:44
016 Antigone centre,6,10,16,2022,01-16,00:44
017 Médiathèque Emile Zola,7,9,16,2022,01-16,00:44
018 Nombre d'Or,8,8,16,2022,01-16,00:44
019 Louis Blanc,5,11,16,2022,01-16,00:44
020 Gambetta,4,4,8,2022,01-16,00:44
021 Port Marianne,13,3,16,2022,01-16,00:44
022 Clemenceau,0,12,12,2022,01-16,00:44
023 Les Arceaux,10,6,16,2022,01-16,00:44
024 Cité Mion,5,3,8,2022,01-16,00:44
025 Nouveau Saint-Roch,4,4,8,2022,01-16,00:44
026 Renouvier,3,5,8,2022,01-16,00:44
027 Odysseum,4,4,8,2022,01-16,00:44
028 Saint-Denis,4,4,8,2022,01-16,00:44
029 Richter,13,3,16,2022,01-16,00:44
030 Charles Flahault,3,5,8,2022,01-16,00:44
031 Voltaire,7,1,8,2022,01-16,00:44
032 Prés d'Arènes,8,0,8,2022,01-16,00:44
033 Garcia Lorca,6,2,8,2022,01-16,00:44
034 Vert Bois,0,16,16,2022,01-16,00:44
035 Malbosc,3,5,8,2022,01-16,00:44
036 Occitanie,2,30,32,2022,01-16,00:44
037 FacdesSciences,7,17,24,2022,01-16,00:44
038 Fac de Lettres,0,16,16,2022,01-16,00:44
039 Aiguelongue,8,0,8,2022,01-16,00:44
040 Jeu de Mail des Abbés,3,5,8,2022,01-16,00:44
041 Euromédecine,3,5,8,2022,01-16,00:44
042 Marie Caizergues,1,7,8,2022,01-16,00:44
043 Sabines,6,2,8,2022,01-16,00:44
044 Celleneuve,5,3,8,2022,01-16,00:44
045 Jardin de la Lironde,4,4,8,2022,01-16,00:44
046 Père Soulas,2,6,8,2022,01-16,00:44
047 Place Viala,5,3,8,2022,01-16,00:44
048 Hôtel du Département,2,6,8,2022,01-16,00:44
049 Tonnelles,1,7,8,2022,01-16,00:44
050 Parvis Jules Ferry - Gare Saint-Roch,4,4,8,2022,01-16,00:44
051 Pont de Lattes - Gare Saint-Roch,6,6,12,2022,01-16,00:44
053 Deux Ponts - Gare Saint-Roch,3,5,8,2022,01-16,00:44
054 Providence - Ovalie,0,8,8,2022,01-16,00:44
055 Pérols Etang de l'Or,23,45,68,2022,01-16,00:44
056 Albert 1er - Cathédrale,1,11,12,2022,01-16,00:44
057 Saint-Guilhem - Courreau,4,4,8,2022,01-16,00:44
059 Sud De France,1,7,8,2022,01-16,00:44
station_name,taken_vmag_space,free_vmag_space,total_vmag_space,year,day&month,hour&min
001 Rue Jules Ferry - Gare Saint-Roch,2,10,12,2022,01-16,00:45
002 Comédie,8,16,24,2022,01-16,00:45
003 Esplanade,2,30,32,2022,01-16,00:45
004 Hôtel de Ville,7,9,16,2022,01-16,00:45
005 Corum,8,4,12,2022,01-16,00:45
006 Place Albert 1er - St Charles,10,21,31,2022,01-16,00:45
007 Foch,1,7,8,2022,01-16,00:45
008 Halles Castellane,0,12,12,2022,01-16,00:45
009 Observatoire,2,6,8,2022,01-16,00:45
010 Rondelet,2,14,16,2022,01-16,00:45
011 Plan Cabanes,5,7,12,2022,01-16,00:45
012 Boutonnet,3,9,12,2022,01-16,00:45
013 Emile Combes,5,3,8,2022,01-16,00:45
014 Beaux-Arts,6,2,8,2022,01-16,00:45
015 Les Aubes,8,0,8,2022,01-16,00:45
016 Antigone centre,6,10,16,2022,01-16,00:45
017 Médiathèque Emile Zola,7,9,16,2022,01-16,00:45
018 Nombre d'Or,8,8,16,2022,01-16,00:45
019 Louis Blanc,5,11,16,2022,01-16,00:45
020 Gambetta,4,4,8,2022,01-16,00:45
021 Port Marianne,12,4,16,2022,01-16,00:45
022 Clemenceau,0,12,12,2022,01-16,00:45
023 Les Arceaux,10,6,16,2022,01-16,00:45
024 Cité Mion,5,3,8,2022,01-16,00:45
025 Nouveau Saint-Roch,4,4,8,2022,01-16,00:45
026 Renouvier,2,6,8,2022,01-16,00:45
027 Odysseum,4,4,8,2022,01-16,00:45
028 Saint-Denis,4,4,8,2022,01-16,00:45
029 Richter,13,3,16,2022,01-16,00:45
030 Charles Flahault,3,5,8,2022,01-16,00:45
031 Voltaire,7,1,8,2022,01-16,00:45
032 Prés d'Arènes,8,0,8,2022,01-16,00:45
033 Garcia Lorca,6,2,8,2022,01-16,00:45
034 Vert Bois,0,16,16,2022,01-16,00:45
035 Malbosc,3,5,8,2022,01-16,00:45
036 Occitanie,2,30,32,2022,01-16,00:45
037 FacdesSciences,7,17,24,2022,01-16,00:45
038 Fac de Lettres,0,16,16,2022,01-16,00:45
039 Aiguelongue,8,0,8,2022,01-16,00:45
040 Jeu de Mail des Abbés,3,5,8,2022,01-16,00:45
041 Euromédecine,3,5,8,2022,01-16,00:45
042 Marie Caizergues,1,7,8,2022,01-16,00:45
043 Sabines,6,2,8,2022,01-16,00:45
044 Celleneuve,5,3,8,2022,01-16,00:45
045 Jardin de la Lironde,4,4,8,2022,01-16,00:45
046 Père Soulas,2,6,8,2022,01-16,00:45
047 Place Viala,5,3,8,2022,01-16,00:45
048 Hôtel du Département,2,6,8,2022,01-16,00:45
049 Tonnelles,1,7,8,2022,01-16,00:45
050 Parvis Jules Ferry - Gare Saint-Roch,4,4,8,2022,01-16,00:45
051 Pont de Lattes - Gare Saint-Roch,6,6,12,2022,01-16,00:45
053 Deux Ponts - Gare Saint-Roch,3,5,8,2022,01-16,00:45
054 Providence - Ovalie,0,8,8,2022,01-16,00:45
055 Pérols Etang de l'Or,23,45,68,2022,01-16,00:45
056 Albert 1er - Cathédrale,1,11,12,2022,01-16,00:45
057 Saint-Guilhem - Courreau,4,4,8,2022,01-16,00:45
059 Sud De France,1,7,8,2022,01-16,00:45
station_name,taken_vmag_space,free_vmag_space,total_vmag_space,year,day&month,hour&min
001 Rue Jules Ferry - Gare Saint-Roch,2,10,12,2022,01-16,00:45
002 Comédie,8,16,24,2022,01-16,00:45
003 Esplanade,2,30,32,2022,01-16,00:45
004 Hôtel de Ville,7,9,16,2022,01-16,00:45
005 Corum,8,4,12,2022,01-16,00:45
006 Place Albert 1er - St Charles,10,21,31,2022,01-16,00:45
007 Foch,1,7,8,2022,01-16,00:45
008 Halles Castellane,0,12,12,2022,01-16,00:45
009 Observatoire,2,6,8,2022,01-16,00:45
010 Rondelet,2,14,16,2022,01-16,00:45
011 Plan Cabanes,5,7,12,2022,01-16,00:45
012 Boutonnet,3,9,12,2022,01-16,00:45
013 Emile Combes,5,3,8,2022,01-16,00:45
014 Beaux-Arts,6,2,8,2022,01-16,00:45
015 Les Aubes,8,0,8,2022,01-16,00:45
016 Antigone centre,6,10,16,2022,01-16,00:45
017 Médiathèque Emile Zola,7,9,16,2022,01-16,00:45
018 Nombre d'Or,8,8,16,2022,01-16,00:45
019 Louis Blanc,5,11,16,2022,01-16,00:45
020 Gambetta,4,4,8,2022,01-16,00:45
021 Port Marianne,12,4,16,2022,01-16,00:45
022 Clemenceau,0,12,12,2022,01-16,00:45
023 Les Arceaux,10,6,16,2022,01-16,00:45
024 Cité Mion,5,3,8,2022,01-16,00:45
025 Nouveau Saint-Roch,4,4,8,2022,01-16,00:45
026 Renouvier,2,6,8,2022,01-16,00:45
027 Odysseum,4,4,8,2022,01-16,00:45
028 Saint-Denis,4,4,8,2022,01-16,00:45
029 Richter,13,3,16,2022,01-16,00:45
030 Charles Flahault,3,5,8,2022,01-16,00:45
031 Voltaire,7,1,8,2022,01-16,00:45
032 Prés d'Arènes,8,0,8,2022,01-16,00:45
033 Garcia Lorca,6,2,8,2022,01-16,00:45
034 Vert Bois,0,16,16,2022,01-16,00:45
035 Malbosc,3,5,8,2022,01-16,00:45
036 Occitanie,2,30,32,2022,01-16,00:45
037 FacdesSciences,7,17,24,2022,01-16,00:45
038 Fac de Lettres,0,16,16,2022,01-16,00:45
039 Aiguelongue,8,0,8,2022,01-16,00:45
040 Jeu de Mail des Abbés,3,5,8,2022,01-16,00:45
041 Euromédecine,3,5,8,2022,01-16,00:45
042 Marie Caizergues,1,7,8,2022,01-16,00:45
043 Sabines,6,2,8,2022,01-16,00:45
044 Celleneuve,5,3,8,2022,01-16,00:45
045 Jardin de la Lironde,4,4,8,2022,01-16,00:45
046 Père Soulas,2,6,8,2022,01-16,00:45
047 Place Viala,5,3,8,2022,01-16,00:45
048 Hôtel du Département,2,6,8,2022,01-16,00:45
049 Tonnelles,1,7,8,2022,01-16,00:45
050 Parvis Jules Ferry - Gare Saint-Roch,4,4,8,2022,01-16,00:45
051 Pont de Lattes - Gare Saint-Roch,6,6,12,2022,01-16,00:45
053 Deux Ponts - Gare Saint-Roch,3,5,8,2022,01-16,00:45
054 Providence - Ovalie,0,8,8,2022,01-16,00:45
055 Pérols Etang de l'Or,23,45,68,2022,01-16,00:45
056 Albert 1er - Cathédrale,1,11,12,2022,01-16,00:45
057 Saint-Guilhem - Courreau,4,4,8,2022,01-16,00:45
059 Sud De France,1,7,8,2022,01-16,00:45
station_name,taken_vmag_space,free_vmag_space,total_vmag_space,year,day&month,hour&min
001 Rue Jules Ferry - Gare Saint-Roch,2,10,12,2022,01-16,00:47
002 Comédie,8,16,24,2022,01-16,00:47
003 Esplanade,2,30,32,2022,01-16,00:47
004 Hôtel de Ville,7,9,16,2022,01-16,00:47
005 Corum,8,4,12,2022,01-16,00:47
006 Place Albert 1er - St Charles,10,21,31,2022,01-16,00:47
007 Foch,1,7,8,2022,01-16,00:47
008 Halles Castellane,0,12,12,2022,01-16,00:47
009 Observatoire,2,6,8,2022,01-16,00:47
010 Rondelet,2,14,16,2022,01-16,00:47
011 Plan Cabanes,5,7,12,2022,01-16,00:47
012 Boutonnet,3,9,12,2022,01-16,00:47
013 Emile Combes,5,3,8,2022,01-16,00:47
014 Beaux-Arts,6,2,8,2022,01-16,00:47
015 Les Aubes,8,0,8,2022,01-16,00:47
016 Antigone centre,6,10,16,2022,01-16,00:47
017 Médiathèque Emile Zola,7,9,16,2022,01-16,00:47
018 Nombre d'Or,8,8,16,2022,01-16,00:47
019 Louis Blanc,5,11,16,2022,01-16,00:47
020 Gambetta,4,4,8,2022,01-16,00:47
021 Port Marianne,12,4,16,2022,01-16,00:47
022 Clemenceau,0,12,12,2022,01-16,00:47
023 Les Arceaux,10,6,16,2022,01-16,00:47
024 Cité Mion,5,3,8,2022,01-16,00:47
025 Nouveau Saint-Roch,4,4,8,2022,01-16,00:47
026 Renouvier,2,6,8,2022,01-16,00:47
027 Odysseum,4,4,8,2022,01-16,00:47
028 Saint-Denis,4,4,8,2022,01-16,00:47
029 Richter,13,3,16,2022,01-16,00:47
030 Charles Flahault,3,5,8,2022,01-16,00:47
031 Voltaire,7,1,8,2022,01-16,00:47
032 Prés d'Arènes,8,0,8,2022,01-16,00:47
033 Garcia Lorca,6,2,8,2022,01-16,00:47
034 Vert Bois,0,16,16,2022,01-16,00:47
035 Malbosc,3,5,8,2022,01-16,00:47
036 Occitanie,2,30,32,2022,01-16,00:47
037 FacdesSciences,7,17,24,2022,01-16,00:47
038 Fac de Lettres,0,16,16,2022,01-16,00:47
039 Aiguelongue,8,0,8,2022,01-16,00:47
040 Jeu de Mail des Abbés,3,5,8,2022,01-16,00:47
041 Euromédecine,3,5,8,2022,01-16,00:47
042 Marie Caizergues,1,7,8,2022,01-16,00:47
043 Sabines,6,2,8,2022,01-16,00:47
044 Celleneuve,5,3,8,2022,01-16,00:47
045 Jardin de la Lironde,4,4,8,2022,01-16,00:47
046 Père Soulas,2,6,8,2022,01-16,00:47
047 Place Viala,5,3,8,2022,01-16,00:47
048 Hôtel du Département,2,6,8,2022,01-16,00:47
049 Tonnelles,1,7,8,2022,01-16,00:47
050 Parvis Jules Ferry - Gare Saint-Roch,4,4,8,2022,01-16,00:47
051 Pont de Lattes - Gare Saint-Roch,6,6,12,2022,01-16,00:47
053 Deux Ponts - Gare Saint-Roch,3,5,8,2022,01-16,00:47
054 Providence - Ovalie,0,8,8,2022,01-16,00:47
055 Pérols Etang de l'Or,23,45,68,2022,01-16,00:47
056 Albert 1er - Cathédrale,1,11,12,2022,01-16,00:47
057 Saint-Guilhem - Courreau,4,4,8,2022,01-16,00:47
059 Sud De France,1,7,8,2022,01-16,00:47
station_name,taken_vmag_space,free_vmag_space,total_vmag_space,year,day&month,hour&min
001 Rue Jules Ferry - Gare Saint-Roch,2,10,12,2022,01-16,00:58
002 Comédie,6,18,24,2022,01-16,00:58
003 Esplanade,1,31,32,2022,01-16,00:58
004 Hôtel de Ville,7,9,16,2022,01-16,00:58
005 Corum,8,4,12,2022,01-16,00:58
006 Place Albert 1er - St Charles,10,21,31,2022,01-16,00:58
007 Foch,1,7,8,2022,01-16,00:58
008 Halles Castellane,0,12,12,2022,01-16,00:58
009 Observatoire,2,6,8,2022,01-16,00:58
010 Rondelet,2,14,16,2022,01-16,00:58
011 Plan Cabanes,5,7,12,2022,01-16,00:58
012 Boutonnet,3,9,12,2022,01-16,00:58
013 Emile Combes,5,3,8,2022,01-16,00:58
014 Beaux-Arts,6,2,8,2022,01-16,00:58
015 Les Aubes,8,0,8,2022,01-16,00:58
016 Antigone centre,6,10,16,2022,01-16,00:58
017 Médiathèque Emile Zola,7,9,16,2022,01-16,00:58
018 Nombre d'Or,9,7,16,2022,01-16,00:58
019 Louis Blanc,4,12,16,2022,01-16,00:58
020 Gambetta,4,4,8,2022,01-16,00:58
021 Port Marianne,11,5,16,2022,01-16,00:58
022 Clemenceau,1,11,12,2022,01-16,00:58
023 Les Arceaux,9,7,16,2022,01-16,00:58
024 Cité Mion,5,3,8,2022,01-16,00:58
025 Nouveau Saint-Roch,4,4,8,2022,01-16,00:58
026 Renouvier,2,6,8,2022,01-16,00:58
027 Odysseum,4,4,8,2022,01-16,00:58
028 Saint-Denis,4,4,8,2022,01-16,00:58
029 Richter,13,3,16,2022,01-16,00:58
030 Charles Flahault,3,5,8,2022,01-16,00:58
031 Voltaire,7,1,8,2022,01-16,00:58
032 Prés d'Arènes,8,0,8,2022,01-16,00:58
033 Garcia Lorca,6,2,8,2022,01-16,00:58
034 Vert Bois,0,16,16,2022,01-16,00:58
035 Malbosc,3,5,8,2022,01-16,00:58
036 Occitanie,2,30,32,2022,01-16,00:58
037 FacdesSciences,7,17,24,2022,01-16,00:58
038 Fac de Lettres,0,16,16,2022,01-16,00:58
039 Aiguelongue,8,0,8,2022,01-16,00:58
040 Jeu de Mail des Abbés,3,5,8,2022,01-16,00:58
041 Euromédecine,3,5,8,2022,01-16,00:58
042 Marie Caizergues,1,7,8,2022,01-16,00:58
043 Sabines,6,2,8,2022,01-16,00:58
044 Celleneuve,5,3,8,2022,01-16,00:58
045 Jardin de la Lironde,4,4,8,2022,01-16,00:58
046 Père Soulas,4,4,8,2022,01-16,00:58
047 Place Viala,5,3,8,2022,01-16,00:58
048 Hôtel du Département,2,6,8,2022,01-16,00:58
049 Tonnelles,1,7,8,2022,01-16,00:58
050 Parvis Jules Ferry - Gare Saint-Roch,5,3,8,2022,01-16,00:58
051 Pont de Lattes - Gare Saint-Roch,6,6,12,2022,01-16,00:58
053 Deux Ponts - Gare Saint-Roch,3,5,8,2022,01-16,00:58
054 Providence - Ovalie,0,8,8,2022,01-16,00:58
055 Pérols Etang de l'Or,23,45,68,2022,01-16,00:58
056 Albert 1er - Cathédrale,1,11,12,2022,01-16,00:58
057 Saint-Guilhem - Courreau,4,4,8,2022,01-16,00:58
059 Sud De France,1,7,8,2022,01-16,00:58
station_name,taken_vmag_space,free_vmag_space,total_vmag_space,year,day&month,hour&min
001 Rue Jules Ferry - Gare Saint-Roch,1,11,12,2022,01-16,01:09
002 Comédie,6,18,24,2022,01-16,01:09
003 Esplanade,1,31,32,2022,01-16,01:09
004 Hôtel de Ville,7,9,16,2022,01-16,01:09
005 Corum,7,5,12,2022,01-16,01:09
006 Place Albert 1er - St Charles,10,21,31,2022,01-16,01:09
007 Foch,1,7,8,2022,01-16,01:09
008 Halles Castellane,0,12,12,2022,01-16,01:09
009 Observatoire,2,6,8,2022,01-16,01:09
010 Rondelet,2,14,16,2022,01-16,01:09
011 Plan Cabanes,5,7,12,2022,01-16,01:09
012 Boutonnet,3,9,12,2022,01-16,01:09
013 Emile Combes,5,3,8,2022,01-16,01:09
014 Beaux-Arts,6,2,8,2022,01-16,01:09
015 Les Aubes,8,0,8,2022,01-16,01:09
016 Antigone centre,7,9,16,2022,01-16,01:09
017 Médiathèque Emile Zola,7,9,16,2022,01-16,01:09
018 Nombre d'Or,9,7,16,2022,01-16,01:09
019 Louis Blanc,4,12,16,2022,01-16,01:09
020 Gambetta,4,4,8,2022,01-16,01:09
021 Port Marianne,11,5,16,2022,01-16,01:09
022 Clemenceau,1,11,12,2022,01-16,01:09
023 Les Arceaux,9,7,16,2022,01-16,01:09
024 Cité Mion,5,3,8,2022,01-16,01:09
025 Nouveau Saint-Roch,4,4,8,2022,01-16,01:09
026 Renouvier,2,6,8,2022,01-16,01:09
027 Odysseum,4,4,8,2022,01-16,01:09
028 Saint-Denis,4,4,8,2022,01-16,01:09
029 Richter,13,3,16,2022,01-16,01:09
030 Charles Flahault,3,5,8,2022,01-16,01:09
031 Voltaire,6,2,8,2022,01-16,01:09
032 Prés d'Arènes,8,0,8,2022,01-16,01:09
033 Garcia Lorca,6,2,8,2022,01-16,01:09
034 Vert Bois,0,16,16,2022,01-16,01:09
035 Malbosc,3,5,8,2022,01-16,01:09
036 Occitanie,3,29,32,2022,01-16,01:09
037 FacdesSciences,8,16,24,2022,01-16,01:09
038 Fac de Lettres,0,16,16,2022,01-16,01:09
039 Aiguelongue,8,0,8,2022,01-16,01:09
040 Jeu de Mail des Abbés,3,5,8,2022,01-16,01:09
041 Euromédecine,3,5,8,2022,01-16,01:09
042 Marie Caizergues,1,7,8,2022,01-16,01:09
043 Sabines,6,2,8,2022,01-16,01:09
044 Celleneuve,5,3,8,2022,01-16,01:09
045 Jardin de la Lironde,4,4,8,2022,01-16,01:09
046 Père Soulas,8,0,8,2022,01-16,01:09
047 Place Viala,4,4,8,2022,01-16,01:09
048 Hôtel du Département,2,6,8,2022,01-16,01:09
049 Tonnelles,1,7,8,2022,01-16,01:09
050 Parvis Jules Ferry - Gare Saint-Roch,5,3,8,2022,01-16,01:09
051 Pont de Lattes - Gare Saint-Roch,5,7,12,2022,01-16,01:09
053 Deux Ponts - Gare Saint-Roch,3,5,8,2022,01-16,01:09
054 Providence - Ovalie,0,8,8,2022,01-16,01:09
055 Pérols Etang de l'Or,23,45,68,2022,01-16,01:09
056 Albert 1er - Cathédrale,1,11,12,2022,01-16,01:09
057 Saint-Guilhem - Courreau,5,3,8,2022,01-16,01:09
059 Sud De France,1,7,8,2022,01-16,01:09
station_name,taken_vmag_space,free_vmag_space,total_vmag_space,year,day&month,hour&min
001 Rue Jules Ferry - Gare Saint-Roch,2,10,12,2022,01-16,01:20
002 Comédie,7,17,24,2022,01-16,01:20
003 Esplanade,1,31,32,2022,01-16,01:20
004 Hôtel de Ville,7,9,16,2022,01-16,01:20
005 Corum,7,5,12,2022,01-16,01:20
006 Place Albert 1er - St Charles,10,21,31,2022,01-16,01:20
007 Foch,1,7,8,2022,01-16,01:20
008 Halles Castellane,0,12,12,2022,01-16,01:20
009 Observatoire,2,6,8,2022,01-16,01:20
010 Rondelet,2,14,16,2022,01-16,01:20
011 Plan Cabanes,5,7,12,2022,01-16,01:20
012 Boutonnet,3,9,12,2022,01-16,01:20
013 Emile Combes,5,3,8,2022,01-16,01:20
014 Beaux-Arts,6,2,8,2022,01-16,01:20
015 Les Aubes,8,0,8,2022,01-16,01:20
016 Antigone centre,7,9,16,2022,01-16,01:20
017 Médiathèque Emile Zola,7,9,16,2022,01-16,01:20
018 Nombre d'Or,9,7,16,2022,01-16,01:20
019 Louis Blanc,3,13,16,2022,01-16,01:20
020 Gambetta,4,4,8,2022,01-16,01:20
021 Port Marianne,11,5,16,2022,01-16,01:20
022 Clemenceau,1,11,12,2022,01-16,01:20
023 Les Arceaux,9,7,16,2022,01-16,01:20
024 Cité Mion,5,3,8,2022,01-16,01:20
025 Nouveau Saint-Roch,4,4,8,2022,01-16,01:20
026 Renouvier,3,5,8,2022,01-16,01:20
027 Odysseum,4,4,8,2022,01-16,01:20
028 Saint-Denis,4,4,8,2022,01-16,01:20
029 Richter,13,3,16,2022,01-16,01:20
030 Charles Flahault,5,3,8,2022,01-16,01:20
031 Voltaire,6,2,8,2022,01-16,01:20
032 Prés d'Arènes,8,0,8,2022,01-16,01:20
033 Garcia Lorca,6,2,8,2022,01-16,01:20
034 Vert Bois,0,16,16,2022,01-16,01:20
035 Malbosc,3,5,8,2022,01-16,01:20
036 Occitanie,3,29,32,2022,01-16,01:20
037 FacdesSciences,8,16,24,2022,01-16,01:20
038 Fac de Lettres,0,16,16,2022,01-16,01:20
039 Aiguelongue,8,0,8,2022,01-16,01:20
040 Jeu de Mail des Abbés,3,5,8,2022,01-16,01:20
041 Euromédecine,3,5,8,2022,01-16,01:20
042 Marie Caizergues,1,7,8,2022,01-16,01:20
043 Sabines,6,2,8,2022,01-16,01:20
044 Celleneuve,5,3,8,2022,01-16,01:20
045 Jardin de la Lironde,4,4,8,2022,01-16,01:20
046 Père Soulas,8,0,8,2022,01-16,01:20
047 Place Viala,4,4,8,2022,01-16,01:20
048 Hôtel du Département,2,6,8,2022,01-16,01:20
049 Tonnelles,1,7,8,2022,01-16,01:20
050 Parvis Jules Ferry - Gare Saint-Roch,5,3,8,2022,01-16,01:20
051 Pont de Lattes - Gare Saint-Roch,5,7,12,2022,01-16,01:20
053 Deux Ponts - Gare Saint-Roch,3,5,8,2022,01-16,01:20
054 Providence - Ovalie,0,8,8,2022,01-16,01:20
055 Pérols Etang de l'Or,23,45,68,2022,01-16,01:20
056 Albert 1er - Cathédrale,1,11,12,2022,01-16,01:20
057 Saint-Guilhem - Courreau,5,3,8,2022,01-16,01:20
059 Sud De France,1,7,8,2022,01-16,01:20
station_name,taken_vmag_space,free_vmag_space,total_vmag_space,year,day&month,hour&min
001 Rue Jules Ferry - Gare Saint-Roch,2,10,12,2022,01-16,01:31
002 Comédie,7,17,24,2022,01-16,01:31
003 Esplanade,1,31,32,2022,01-16,01:31
004 Hôtel de Ville,7,9,16,2022,01-16,01:31
005 Corum,7,5,12,2022,01-16,01:31
006 Place Albert 1er - St Charles,10,21,31,2022,01-16,01:31
007 Foch,1,7,8,2022,01-16,01:31
008 Halles Castellane,0,12,12,2022,01-16,01:31
009 Observatoire,1,7,8,2022,01-16,01:31
010 Rondelet,2,14,16,2022,01-16,01:31
011 Plan Cabanes,5,7,12,2022,01-16,01:31
012 Boutonnet,3,9,12,2022,01-16,01:31
013 Emile Combes,5,3,8,2022,01-16,01:31
014 Beaux-Arts,6,2,8,2022,01-16,01:31
015 Les Aubes,8,0,8,2022,01-16,01:31
016 Antigone centre,7,9,16,2022,01-16,01:31
017 Médiathèque Emile Zola,7,9,16,2022,01-16,01:31
018 Nombre d'Or,9,7,16,2022,01-16,01:31
019 Louis Blanc,2,14,16,2022,01-16,01:31
020 Gambetta,4,4,8,2022,01-16,01:31
021 Port Marianne,11,5,16,2022,01-16,01:31
022 Clemenceau,1,11,12,2022,01-16,01:31
023 Les Arceaux,9,7,16,2022,01-16,01:31
024 Cité Mion,5,3,8,2022,01-16,01:31
025 Nouveau Saint-Roch,4,4,8,2022,01-16,01:31
026 Renouvier,4,4,8,2022,01-16,01:31
027 Odysseum,4,4,8,2022,01-16,01:31
028 Saint-Denis,4,4,8,2022,01-16,01:31
029 Richter,13,3,16,2022,01-16,01:31
030 Charles Flahault,5,3,8,2022,01-16,01:31
031 Voltaire,6,2,8,2022,01-16,01:31
032 Prés d'Arènes,8,0,8,2022,01-16,01:31
033 Garcia Lorca,6,2,8,2022,01-16,01:31
034 Vert Bois,0,16,16,2022,01-16,01:31
035 Malbosc,3,5,8,2022,01-16,01:31
036 Occitanie,5,27,32,2022,01-16,01:31
037 FacdesSciences,8,16,24,2022,01-16,01:31
038 Fac de Lettres,0,16,16,2022,01-16,01:31
039 Aiguelongue,7,1,8,2022,01-16,01:31
040 Jeu de Mail des Abbés,3,5,8,2022,01-16,01:31
041 Euromédecine,3,5,8,2022,01-16,01:31
042 Marie Caizergues,1,7,8,2022,01-16,01:31
043 Sabines,6,2,8,2022,01-16,01:31
044 Celleneuve,5,3,8,2022,01-16,01:31
045 Jardin de la Lironde,4,4,8,2022,01-16,01:31
046 Père Soulas,8,0,8,2022,01-16,01:31
047 Place Viala,4,4,8,2022,01-16,01:31
048 Hôtel du Département,2,6,8,2022,01-16,01:31
049 Tonnelles,1,7,8,2022,01-16,01:31
050 Parvis Jules Ferry - Gare Saint-Roch,5,3,8,2022,01-16,01:31
051 Pont de Lattes - Gare Saint-Roch,5,7,12,2022,01-16,01:31
053 Deux Ponts - Gare Saint-Roch,3,5,8,2022,01-16,01:31
054 Providence - Ovalie,0,8,8,2022,01-16,01:31
055 Pérols Etang de l'Or,23,45,68,2022,01-16,01:31
056 Albert 1er - Cathédrale,1,11,12,2022,01-16,01:31
057 Saint-Guilhem - Courreau,5,3,8,2022,01-16,01:31
059 Sud De France,1,7,8,2022,01-16,01:31
station_name,taken_vmag_space,free_vmag_space,total_vmag_space,year,day&month,hour&min
001 Rue Jules Ferry - Gare Saint-Roch,2,10,12,2022,01-16,01:39
002 Comédie,7,17,24,2022,01-16,01:39
003 Esplanade,1,31,32,2022,01-16,01:39
004 Hôtel de Ville,7,9,16,2022,01-16,01:39
005 Corum,7,5,12,2022,01-16,01:39
006 Place Albert 1er - St Charles,10,21,31,2022,01-16,01:39
007 Foch,1,7,8,2022,01-16,01:39
008 Halles Castellane,0,12,12,2022,01-16,01:39
009 Observatoire,1,7,8,2022,01-16,01:39
010 Rondelet,2,14,16,2022,01-16,01:39
011 Plan Cabanes,5,7,12,2022,01-16,01:39
012 Boutonnet,3,9,12,2022,01-16,01:39
013 Emile Combes,5,3,8,2022,01-16,01:39
014 Beaux-Arts,6,2,8,2022,01-16,01:39
015 Les Aubes,8,0,8,2022,01-16,01:39
016 Antigone centre,7,9,16,2022,01-16,01:39
017 Médiathèque Emile Zola,7,9,16,2022,01-16,01:39
018 Nombre d'Or,9,7,16,2022,01-16,01:39
019 Louis Blanc,2,14,16,2022,01-16,01:39
020 Gambetta,4,4,8,2022,01-16,01:39
021 Port Marianne,11,5,16,2022,01-16,01:39
022 Clemenceau,1,11,12,2022,01-16,01:39
023 Les Arceaux,9,7,16,2022,01-16,01:39
024 Cité Mion,5,3,8,2022,01-16,01:39
025 Nouveau Saint-Roch,4,4,8,2022,01-16,01:39
026 Renouvier,4,4,8,2022,01-16,01:39
027 Odysseum,4,4,8,2022,01-16,01:39
028 Saint-Denis,4,4,8,2022,01-16,01:39
029 Richter,13,3,16,2022,01-16,01:39
030 Charles Flahault,5,3,8,2022,01-16,01:39
031 Voltaire,6,2,8,2022,01-16,01:39
032 Prés d'Arènes,8,0,8,2022,01-16,01:39
033 Garcia Lorca,5,3,8,2022,01-16,01:39
034 Vert Bois,0,16,16,2022,01-16,01:39
035 Malbosc,3,5,8,2022,01-16,01:39
036 Occitanie,7,25,32,2022,01-16,01:39
037 FacdesSciences,8,16,24,2022,01-16,01:39
038 Fac de Lettres,0,16,16,2022,01-16,01:39
039 Aiguelongue,7,1,8,2022,01-16,01:39
040 Jeu de Mail des Abbés,3,5,8,2022,01-16,01:39
041 Euromédecine,3,5,8,2022,01-16,01:39
042 Marie Caizergues,1,7,8,2022,01-16,01:39
043 Sabines,6,2,8,2022,01-16,01:39
044 Celleneuve,5,3,8,2022,01-16,01:39
045 Jardin de la Lironde,4,4,8,2022,01-16,01:39
046 Père Soulas,6,2,8,2022,01-16,01:39
047 Place Viala,3,5,8,2022,01-16,01:39
048 Hôtel du Département,2,6,8,2022,01-16,01:39
049 Tonnelles,1,7,8,2022,01-16,01:39
050 Parvis Jules Ferry - Gare Saint-Roch,5,3,8,2022,01-16,01:39
051 Pont de Lattes - Gare Saint-Roch,5,7,12,2022,01-16,01:39
053 Deux Ponts - Gare Saint-Roch,3,5,8,2022,01-16,01:39
054 Providence - Ovalie,0,8,8,2022,01-16,01:39
055 Pérols Etang de l'Or,23,45,68,2022,01-16,01:39
056 Albert 1er - Cathédrale,1,11,12,2022,01-16,01:39
057 Saint-Guilhem - Courreau,5,3,8,2022,01-16,01:39
059 Sud De France,1,7,8,2022,01-16,01:39
station_name,taken_vmag_space,free_vmag_space,total_vmag_space,year,day&month,hour&min
001 Rue Jules Ferry - Gare Saint-Roch,2,10,12,2022,01-16,01:40
002 Comédie,7,17,24,2022,01-16,01:40
003 Esplanade,1,31,32,2022,01-16,01:40
004 Hôtel de Ville,7,9,16,2022,01-16,01:40
005 Corum,7,5,12,2022,01-16,01:40
006 Place Albert 1er - St Charles,10,21,31,2022,01-16,01:40
007 Foch,1,7,8,2022,01-16,01:40
008 Halles Castellane,0,12,12,2022,01-16,01:40
009 Observatoire,1,7,8,2022,01-16,01:40
010 Rondelet,2,14,16,2022,01-16,01:40
011 Plan Cabanes,5,7,12,2022,01-16,01:40
012 Boutonnet,3,9,12,2022,01-16,01:40
013 Emile Combes,5,3,8,2022,01-16,01:40
014 Beaux-Arts,6,2,8,2022,01-16,01:40
015 Les Aubes,8,0,8,2022,01-16,01:40
016 Antigone centre,7,9,16,2022,01-16,01:40
017 Médiathèque Emile Zola,7,9,16,2022,01-16,01:40
018 Nombre d'Or,9,7,16,2022,01-16,01:40
019 Louis Blanc,2,14,16,2022,01-16,01:40
020 Gambetta,4,4,8,2022,01-16,01:40
021 Port Marianne,11,5,16,2022,01-16,01:40
022 Clemenceau,1,11,12,2022,01-16,01:40
023 Les Arceaux,9,7,16,2022,01-16,01:40
024 Cité Mion,5,3,8,2022,01-16,01:40
025 Nouveau Saint-Roch,4,4,8,2022,01-16,01:40
026 Renouvier,4,4,8,2022,01-16,01:40
027 Odysseum,4,4,8,2022,01-16,01:40
028 Saint-Denis,4,4,8,2022,01-16,01:40
029 Richter,13,3,16,2022,01-16,01:40
030 Charles Flahault,5,3,8,2022,01-16,01:40
031 Voltaire,6,2,8,2022,01-16,01:40
032 Prés d'Arènes,8,0,8,2022,01-16,01:40
033 Garcia Lorca,5,3,8,2022,01-16,01:40
034 Vert Bois,0,16,16,2022,01-16,01:40
035 Malbosc,3,5,8,2022,01-16,01:40
036 Occitanie,7,25,32,2022,01-16,01:40
037 FacdesSciences,8,16,24,2022,01-16,01:40
038 Fac de Lettres,0,16,16,2022,01-16,01:40
039 Aiguelongue,7,1,8,2022,01-16,01:40
040 Jeu de Mail des Abbés,3,5,8,2022,01-16,01:40
041 Euromédecine,3,5,8,2022,01-16,01:40
042 Marie Caizergues,1,7,8,2022,01-16,01:40
043 Sabines,6,2,8,2022,01-16,01:40
044 Celleneuve,5,3,8,2022,01-16,01:40
045 Jardin de la Lironde,4,4,8,2022,01-16,01:40
046 Père Soulas,6,2,8,2022,01-16,01:40
047 Place Viala,3,5,8,2022,01-16,01:40
048 Hôtel du Département,2,6,8,2022,01-16,01:40
049 Tonnelles,1,7,8,2022,01-16,01:40
050 Parvis Jules Ferry - Gare Saint-Roch,5,3,8,2022,01-16,01:40
051 Pont de Lattes - Gare Saint-Roch,5,7,12,2022,01-16,01:40
053 Deux Ponts - Gare Saint-Roch,3,5,8,2022,01-16,01:40
054 Providence - Ovalie,0,8,8,2022,01-16,01:40
055 Pérols Etang de l'Or,23,45,68,2022,01-16,01:40
056 Albert 1er - Cathédrale,1,11,12,2022,01-16,01:40
057 Saint-Guilhem - Courreau,5,3,8,2022,01-16,01:40
059 Sud De France,1,7,8,2022,01-16,01:40
